нет	VERB
больной	ADJ
можно	ADV
хорошо	ADV
удобный	ADJ
достаточно	ADV
сложный	ADJ
чисто	ADV
легкий	ADJ
надо	ADV
хороший	ADJ
мало	ADV
нельзя	ADV
близко	ADV
довольно	ADV
здоровый	ADJ
рано	ADV
слышно	ADV
удивительно	ADV
полно	ADV
очевидно	ADV
угодно	ADV
неловко	ADV
глупо	ADV
смешно	ADV
опасно	ADV
жаль	ADV
неохота	ADV
далеко	ADV
красиво	ADV
важно	ADV
обязательно	ADV
видно	ADV
правильно	ADV
тяжело	ADV
некуда	ADV
должно	ADV
против	ADV
заметно	ADV
серьезно	ADV
интересно	ADV
недалеко	ADV
удобно	ADV
тихо	ADV
стыдно	ADV
невдомек	ADV
плохо	ADV
дорого	ADV
явно	ADV
прекрасно	ADV
вправе	ADV
сказочно	ADV
неоткуда	ADV
поздно	ADV
естественно	ADV
грешно	ADV
горько	ADV
понятно	ADV
здорово	ADV
ладно	ADV
жалко	ADV
реально	ADV
нефига	ADV
холодно	ADV
непривычно	ADV
впору	ADV
бесплатно	ADV
трудно	ADV
необязательно	ADV
возможно	ADV
легко	ADV
больно	ADV
страшно	ADV
боязно	ADV
прилично	ADV
ясно	ADV
просторно	ADV
поразительно	ADV
дешево	ADV
сложно	ADV
безупречно	ADV
долго	ADV
охота	ADV
печально	ADV
странно	ADV
чересчур	ADV
тесно	ADV
неприятно	ADV
неплохо	ADV
многовато	ADV
худо	ADV
более	ADV
негоже	ADV
просто	ADV
отлично	ADV
скучно	ADV
спокойно	ADV
адекватно	ADV
бессмысленно	ADV
душевно	ADV
излишне	ADV
желательно	ADV
негде	ADV
сверху	ADV
невыносимо	ADV
нормально	ADV
недолго	ADV
достойно	ADV
душно	ADV
невозможно	ADV
темно	ADV
грустно	ADV
весело	ADV
свободно	ADV
далековато	ADV
приятно	ADV
охота	VERB
неохота	VERB
пора	VERB
недосуг	VERB
резон	VERB
след	VERB
лень	VERB
грех	VERB
время	VERB
досуг	VERB
толк	VERB