абаканский	ADJ
абверовец	NOUN
абстрактно 	ADV
абсурдно 	ADV
абцилохордия	NOUN
аватар	NOUN
аватара	NOUN
авиакорпус	NOUN
авиакосмический	ADJ
авиакрыло	NOUN
авианаводчик	NOUN
авианесущий	ADJ
авианосный	ADJ
авиаотряд	NOUN
авиапарк	NOUN
авиаперевозка	NOUN
авиаперевозчик	NOUN
авиаперелет	NOUN
авиапредприятие	NOUN
авиапроисшествие	NOUN
авиапром	NOUN
авионика	NOUN
авраамов	ADJ
автогигант	NOUN
автогоночный	ADJ
автогонщик	NOUN
автогражданка	NOUN
автогражданский	ADJ
автодорога	NOUN
автозагар	NOUN
автозак	NOUN
автоклавный	ADJ
автоконцерн	NOUN
автокорреляционный	ADJ
автокросс	NOUN
автомагнитола	NOUN
автоматически 	ADV
автомойка	NOUN
автомототранспортный	ADJ
автономизация	NOUN
автономно 	ADV
автопроизводитель	NOUN
автопром	NOUN
авторадио	NOUN
авторитетно 	ADV
авторынок	NOUN
автосамосвал	NOUN
автоспортивный	ADJ
автострахование	NOUN
автотехника	NOUN
автоцентр	NOUN
автошоу	NOUN
агарозный	ADJ
агентка	NOUN
агрегация	NOUN
агрегирование	NOUN
агрессивно 	ADV
агролесомелиоративный	ADJ
агролесомелиорация	NOUN
агрофирма	NOUN
агрохолдинг	NOUN
агроэкосистема	NOUN
адамантан	NOUN
адамантансодержащий	ADJ
адаптивность	NOUN
адвербиал	NOUN
адвокатесса	NOUN
адекватно 	ADV
аденовирус	NOUN
админ	NOUN
адресно 	ADV
адсорбат	NOUN
адъювант	NOUN
адье 	INTJ
ажиотажный	ADJ
азартно 	ADV
азер	NOUN
айболит	NOUN
айкидо	NOUN
айн	NOUN
академически 	ADV
аквапарк	NOUN
аккуратненько 	ADV
аккуратно 	ADV
акмолинский	ADJ
аковец	NOUN
аксаковский	ADJ
аксеновский	ADJ
аксиологический	ADJ
актантный	ADJ
активнейший	ADJ
активно 	ADV
актиноид	NOUN
актор	NOUN
актуально 	ADV
акцепторный	ADJ
акционирование	NOUN
акционировать	VERB
алайский	ADJ
аланинаминотрансфераза	NOUN
алданский	ADJ
александринский	ADJ
алексеевский	ADJ
алексей	NOUN
аликвота	NOUN
алинский	ADJ
алия	NOUN
алкан	NOUN
алкильный	ADJ
аллантоисный	ADJ
алтуфьевский	ADJ
алчно 	ADV
альмекский	ADJ
альтернативщик	NOUN
альфовец	NOUN
алюминид	NOUN
алюминщик	NOUN
аляска	NOUN
амбициозность	NOUN
американ	NOUN
амиксин	NOUN
ампликон	NOUN
амплифицировать	VERB
амфетамин	NOUN
амфибийный	ADJ
анаграммный	ADJ
аналитически 	ADV
аналогично 	ADV
анамезон	NOUN
анастомозировать	VERB
анатомически 	ADV
ангажированность	NOUN
ангарский	ADJ
андеррайтер	NOUN
андроид	NOUN
андроповский	ADJ
аниматор	NOUN
анимационный	ADJ
анкетирование	NOUN
аномально 	ADV
аномийный	ADJ
аномия	NOUN
анонимно 	ADV
анорексия	NOUN
антибюрократический	ADJ
антивирусный	ADJ
антигемагглютинин	NOUN
антигенность	NOUN
антигенный	ADJ
антигерпетический	ADJ
антигистаминный	ADJ
антиглобалист	NOUN
антиглобалистский	ADJ
антигуманный	ADJ
антидемпинговый	ADJ
антидопинговый	ADJ
антиеврейский	ADJ
антизападный	ADJ
антиизраильский	ADJ
антииракский	ADJ
антикоммунист	NOUN
антикоррупционный	ADJ
антикрыло	NOUN
антиленинский	ADJ
антилиберальный	ADJ
антимикробный	ADJ
антимонопольный	ADJ
антинаркотический	ADJ
антинациональный	ADJ
антиоксидант	NOUN
антиоксидантный	ADJ
антиолигархический	ADJ
антиохийский	ADJ
антипрезидентский	ADJ
антипригарный	ADJ
антипробуксовочный	ADJ
антирабический	ADJ
антироссийский	ADJ
антирусский	ADJ
антисоветски 	ADV
антисталинизм	NOUN
антисталинист	NOUN
антисталинистский	ADJ
антисталинский	ADJ
антисыворотка	NOUN
антитеррор	NOUN
антитеррористический	ADJ
антиферромагнитный	ADJ
антихристианский	ADJ
антихристов	ADJ
антицеллюлитный	ADJ
антишолоховед	NOUN
антишолоховедение	NOUN
антоновец	NOUN
антрепризный	ADJ
антропный	ADJ
антропогенный	ADJ
апач	NOUN
апокалиптика	NOUN
апоптоз	NOUN
аппетитно 	ADV
априорно 	ADV
апроксимировать	VERB
арабидопсис	NOUN
арабика	NOUN
аральский	ADJ
аранжировщик	NOUN
арбидол	NOUN
арбовирус	NOUN
арбовирусный	ADJ
аргументированный	ADJ
аргунский	ADJ
арендодатель	NOUN
аридный	ADJ
арий	NOUN
аристократически 	ADV
аристотелевский	ADJ
ароматерапия	NOUN
арт-директор	NOUN
артековский	ADJ
артистически 	ADV
артистический	ADJ
артистично 	ADV
архетипический	ADJ
архиважный	ADJ
архисложный	ADJ
асана	NOUN
аск	NOUN
аспонтанность	NOUN
ассасин	NOUN
ассерция	NOUN
ассизский	ADJ
ассириолог	NOUN
астафьевский	ADJ
астрал	NOUN
астровирус	NOUN
астронавигатор	NOUN
асцитический	ADJ
атас 	INTJ
атипичный	ADJ
атрибутик	NOUN
атрибутика	NOUN
атрибутировать	VERB
аттендинг	NOUN
аттенуация	NOUN
аттитюд	NOUN
аттрактивный	ADJ
аттрактор	NOUN
аудиозапись	NOUN
аудиосистема	NOUN
аудиотехника	NOUN
аусвайс	NOUN
аутгруппа	NOUN
аутентификация	NOUN
аутоиммунный	ADJ
аутсорсинг	NOUN
аферизм	NOUN
афроамериканский	ADJ
аффилировать	VERB
ахматовский	ADJ
ахматовский	ADJ
ахтунг 	INTJ
ацетальдегид	NOUN
ацетилсалициловый	ADJ
ацикловир	NOUN
ашрам	NOUN
аэромобильный	ADJ
аэропортовский	ADJ
аэрофотоснимок	NOUN
аят	NOUN
бабаевский	ADJ
бабелевский	ADJ
бабец	NOUN
бабулька	NOUN
бабушкинский	ADJ
багровейший	ADJ
баженовский	ADJ
базальный	ADJ
базарчик	NOUN
базистернум	NOUN
базицеркальный	ADJ
байда	NOUN
байкер	NOUN
бакалавриат	NOUN
бакалейщица	NOUN
бакс	NOUN
бакуловирус	NOUN
бакуловирусный	ADJ
балаковский	ADJ
балашихинский	ADJ
балашовский	ADJ
балочка	NOUN
бан	NOUN
банальнейший	ADJ
банально 	ADV
бангкокский	ADJ
бандана	NOUN
бандгруппа	NOUN
бандюк	NOUN
банзай 	INTJ
банкинг	NOUN
банкротить	VERB
баннер	NOUN
баннерный	ADJ
баньян	NOUN
барановский	ADJ
бардовский	ADJ
бардымский	ADJ
барионный	ADJ
барный	ADJ
бархатно 	ADV
барьерно 	ADV
баснословно 	ADV
басовито 	ADV
батик	NOUN
батоно	NOUN
батуринский	ADJ
батяня	NOUN
бауманский	ADJ
баурсак	NOUN
баховский	ADJ
бахтинский	ADJ
бахчисарайский	ADJ
башли	NOUN
бденье	NOUN
бдительно 	ADV
бегемотик	NOUN
бегло 	ADV
бедновато 	ADV
бедоносец	NOUN
безальтернативность	NOUN
безальтернативный	ADJ
безапелляционно 	ADV
безбашенный	ADJ
безбедно 	ADV
безбожно 	ADV
безболезненно 	ADV
безбоязненно 	ADV
безбумажный	ADJ
безвестно 	ADV
безвинно 	ADV
безвкуснейший	ADJ
безвозвратно 	ADV
безвозмездно 	ADV
безвольно 	ADV
безвредно 	ADV
безвременно 	ADV
безграмотно 	ADV
безгранично 	ADV
бездарнейший	ADJ
бездарно 	ADV
бездоказательно 	ADV
бездокументарный	ADJ
бездумно 	ADV
безжизненно 	ADV
беззаботно 	ADV
беззаветно 	ADV
беззастенчиво 	ADV
беззащитно 	ADV
беззвучно 	ADV
беззлобно 	ADV
безлюдно 	ADV
безмерно 	ADV
безмолвно 	ADV
безмятежнейший	ADJ
безмятежно 	ADV
безнадежнейший	ADJ
безнадежно 	ADV
безнадежно 	PRED
безнаказанно 	ADV
безобиднейший	ADJ
безобидно 	ADV
безоблачно 	ADV
безобразнейший	ADJ
безобразно 	ADV
безоглядно 	ADV
безоговорочно 	ADV
безопаснейший	ADJ
безопасно 	ADV
безостановочно 	ADV
безответно 	ADV
безответственнейший	ADJ
безответственно 	ADV
безотзывный	ADJ
безотказно 	ADV
безотлагательно 	ADV
безотносительно 	ADV
безотраднейший	ADJ
безотчетно 	ADV
безошибочно 	ADV
безрадостно 	ADV
безраздельно 	ADV
безрассудно 	ADV
безрезультатно 	ADV
безрелигиозный	ADJ
безропотно 	ADV
безудержно 	ADV
безукоризненно 	ADV
безумнейший	ADJ
безумно 	ADV
безупречно 	ADV
безуспешно 	ADV
безутешно 	ADV
безучастно 	ADV
безысходно 	ADV
бейсболка	NOUN
беловежский	ADJ
белоглазый	ADJ
белогорский	ADJ
белозерский	ADJ
белоклювый	ADJ
беломор	NOUN
белостокский	ADJ
белоцерковский	ADJ
бендеровец	NOUN
бенефициар	NOUN
бенефициар	NOUN
бензальдегид	NOUN
бердслейский	ADJ
бережковский	ADJ
бережно 	ADV
березниковский	ADJ
березовский	ADJ
беретта	NOUN
бериевский	ADJ
берсерк	NOUN
бесквартирный	ADJ
бескомпромиссно 	ADV
бесконвойный	ADJ
бесконечно 	ADV
бесконтрольно 	ADV
бескорыстнейший	ADJ
бескорыстно 	ADV
бескровно 	ADV
бескупонный	ADJ
беспардонно 	ADV
бесперебойно 	ADV
беспечнейший	ADJ
беспечно 	ADV
бесплатно 	ADV
бесплодно 	ADV
бесповоротно 	ADV
бесподобнейший	ADJ
бесподобно 	ADV
бесполезнейший	ADJ
беспомощнейший	ADJ
беспомощно 	ADV
беспорядочно 	ADV
беспошлинно 	ADV
беспощадно 	ADV
беспредельно 	ADV
беспредельщик	NOUN
беспрекословно 	ADV
беспрепятственно 	ADV
беспрерывно 	ADV
беспрецедентнейший	ADJ
беспристрастнейший	ADJ
беспристрастно 	ADV
беспроблемный	ADJ
беспробудно 	ADV
беспроводной	ADJ
беспросветно 	ADV
бессвязно 	ADV
бессилье	NOUN
бессильнейший	ADJ
бессильно 	ADV
бессимптомный	ADJ
бессистемно 	ADV
бесславно 	ADV
бесследно 	ADV
бессловесно 	ADV
бессменно 	ADV
бессмертнейший	ADJ
бессмертно 	ADV
бессмертье	NOUN
бессмысленно 	ADV
бессовестно 	ADV
бессознательно 	ADV
бессрочно 	ADV
бесстрастно 	ADV
бесстрашно 	ADV
бесстыднейший	ADJ
бесстыдно 	ADV
бессчетно 	ADV
бессывороточный	ADJ
бестактно 	ADV
бестолково 	ADV
бестраншейный	ADJ
бестрепетно 	ADV
бесхитростно 	ADV
бесхоз	NOUN
бесцельно 	ADV
бесценнейший	ADJ
бесцеремонно 	ADV
бесчестие	NOUN
бесчисленнейший	ADJ
бесчувственно 	ADV
бесшабашно 	ADV
бесшумно 	ADV
бетховенский	ADJ
бешено 	ADV
бивакцина	NOUN
бивалютный	ADJ
бизнес-леди	NOUN
бизнесвумен	NOUN
билборд	NOUN
биллиардный	ADJ
бинго	NOUN
биогеоценоз	NOUN
биоинформатика	NOUN
биокорректор	NOUN
биологически 	ADV
биом	NOUN
биомедицинский	ADJ
биополимер	NOUN
биопроба	NOUN
биопродуктивность	NOUN
биопродукционный	ADJ
биоразнообразие	NOUN
биореактор	NOUN
биоресурсы	NOUN
биосенсор	NOUN
биотерм	NOUN
биотест	NOUN
биотехнологический	ADJ
биотин	NOUN
биотопливо	NOUN
биочип	NOUN
биоэнергетический	ADJ
биробиджанский	ADJ
бирочка	NOUN
бисмарковский	ADJ
битл	NOUN
битловский	ADJ
битовый	ADJ
благовестие	NOUN
благовоспитаннейший	ADJ
благоговейнейший	ADJ
благоговейно 	ADV
благодарнейший	ADJ
благодарно 	ADV
благодатнейший	ADJ
благодушнейший	ADJ
благодушно 	ADV
благожелательнейший	ADJ
благожелательно 	ADV
благонадежнейший	ADJ
благополучнейший	ADJ
благополучно 	ADV
благоприятнейший	ADJ
благоприятно 	ADV
благоразумнейший	ADJ
благоразумно 	ADV
благородно 	ADV
благосклонно 	ADV
благословеннейший	ADJ
благостно 	ADV
благотворно 	ADV
благоуханнейший	ADJ
благочестивейший	ADJ
блаженнейший	ADJ
блаженно 	ADV
блатарь	NOUN
блатхата	NOUN
бледно 	ADV
блендер	NOUN
блескучий	ADJ
блестяще 	ADV
блеянье	NOUN
близняшки	NOUN
близняшки	NOUN
близоруко 	ADV
близь 	ADP
блистательнейший	ADJ
блистательно 	ADV
блокбастер	NOUN
блоковский	ADJ
блюзовый	ADJ
бобовые	ADV
бобровский	ADJ
богато 	ADV
богдановский	ADJ
боговоплощение	NOUN
богоизбранность	NOUN
богоизбранный	ADJ
боголюбивый	ADJ
богообщение	NOUN
богооставленность	NOUN
богопознание	NOUN
богочеловеческий	ADJ
богочеловечество	NOUN
богоявленский	ADJ
бодайбинский	ADJ
боди	NOUN
бодибилдер	NOUN
бодренько 	ADV
бодро 	ADV
боеготовый	ADJ
боестолкновение	NOUN
божественно 	ADV
бозон	NOUN
бойко 	ADV
болдинский	ADJ
болезненно 	ADV
болтливейший	ADJ
больнейший	ADJ
больничка	NOUN
большеберцовый	ADJ
большевистски 	ADV
большевицкий	ADJ
бонжур 	INTJ
бонсай	NOUN
бонусный	ADJ
бореальный	ADJ
борисоглебский	ADJ
бормотанье	NOUN
бормотнуть	VERB
боровский	ADJ
борский	ADJ
бостонский	ADJ
боткинский	ADJ
ботокс	NOUN
боязливо 	ADV
боярка	NOUN
братуха	NOUN
браузер	NOUN
брачность	NOUN
брачующийся	ADJ
брежневский	ADJ
брезгливо 	ADV
бренд	NOUN
брендинг	NOUN
брехтовский	ADJ
брехунец	NOUN
бригаденфюрер	NOUN
бригадефюрер	NOUN
бродвейский	ADJ
бромелаин	NOUN
бронежилет	NOUN
бронетехника	NOUN
бронь	NOUN
броско 	ADV
брошенка	NOUN
брусиловский	ADJ
брутальный	ADJ
брюзгливо 	ADV
брюсовский	ADJ
буднично 	ADV
буйда	NOUN
буйно 	ADV
букер	NOUN
букеровский	ADJ
букмекерский	ADJ
буксирчик	NOUN
булгаковский	ADJ
булгарин	NOUN
бульба	NOUN
бультерьер	NOUN
бунинский	ADJ
бурейский	ADJ
буржуазно 	ADV
буржуин	NOUN
бурно 	ADV
буровзрывной	ADJ
буряк	NOUN
бусидо	NOUN
бусики	NOUN
бутен	NOUN
бутовский	ADJ
бутылек	NOUN
бутырский	ADJ
бухаринский	ADJ
бухучет	NOUN
быстро 	ADV
бытовуха	NOUN
бэтмен	NOUN
бэтээр	NOUN
бюджетирование	NOUN
бюджетообразующий	ADJ
бюджетополучатель	NOUN
бюрократически 	ADV
вагина	NOUN
вагинальный	ADJ
вагнеровский	ADJ
вагонка	NOUN
вайнах	NOUN
вайнахский	ADJ
вакцинальный	ADJ
вакцинопрофилактика	NOUN
валаамский	ADJ
валентинка	NOUN
валер	NOUN
валидность	NOUN
валко 	ADV
валовый	ADJ
вальяжно 	ADV
вампиловский	ADJ
вампирский	ADJ
вампирша	NOUN
варган	NOUN
вариабельность	NOUN
вариабельный	ADJ
варикоз	NOUN
василеостровский	ADJ
васильевский	ADJ
васильковский	ADJ
вау 	INTJ
вахтанговец	NOUN
вахтанговский	ADJ
ваххабизм	NOUN
ваххабит	NOUN
ваххабитский	ADJ
вброс	NOUN
вдавление	NOUN
вдохновенно 	ADV
вдохновенье	NOUN
вдумчиво 	ADV
ведантист	NOUN
ведический	ADJ
ведьмочка	NOUN
вежливо 	ADV
везделет	NOUN
вездеплав	NOUN
вейвлет	NOUN
векторизация	NOUN
великодушно 	ADV
великолепно 	ADV
величаво 	ADV
величественно 	ADV
вельми 	ADV
вентиляторный	ADJ
верейский	ADJ
вероломно 	ADV
вероучительный	ADJ
вертикально 	ADV
верхотурский	ADJ
веселие	NOUN
веско 	ADV
весоизмерительный	ADJ
весомо 	ADV
вестернизация	NOUN
вестминстерский	ADJ
ветинспекция	NOUN
вещдок	NOUN
вещественно 	ADV
вживание	NOUN
вживление	NOUN
взаимно 	ADV
взаимодополнительность	NOUN
взаимодополняющий	ADJ
взаимозачет	NOUN
взаимообогащение	NOUN
взаимоотношения	NOUN
взаимопроникновение	NOUN
взаимосвязанность	NOUN
взвешенность	NOUN
взвешенный	ADJ
взволнованно 	ADV
вздрагивание	NOUN
вздыбливаться	VERB
взметаться	VERB
взращивание	NOUN
взревывать	VERB
взрезаться	VERB
взросление	NOUN
взрывание	NOUN
взрывпакет	NOUN
взыскатель	NOUN
виагра	NOUN
вива 	INTJ
видак	NOUN
виденье	NOUN
видеодвойка	NOUN
видеоизображение	NOUN
видеоинформация	NOUN
видеоконференция	NOUN
видеоматериал	NOUN
видеонаблюдение	NOUN
видеоряд	NOUN
видеосистема	NOUN
видеосъемка	NOUN
видеофон	NOUN
видик	NOUN
видик	NOUN
видоизмененный	ADJ
визгливо 	ADV
визовый	ADJ
визуализировать	VERB
визуально 	ADV
виленский	ADJ
винзавод	NOUN
винницкий	ADJ
виновато 	ADV
вип	NOUN
виразол	NOUN
вирион	NOUN
вирионный	ADJ
виросома	NOUN
виртуализация	NOUN
виртуально 	ADV
виртуозно 	ADV
вирулицидный	ADJ
вирусемия	NOUN
вирусол	NOUN
вирусоноситель	NOUN
вирусоподобный	ADJ
вируссодержащий	ADJ
вирусспецифический	ADJ
витальность	NOUN
витаминка	NOUN
витиевато 	ADV
вице-мэр	NOUN
вице-премьер	NOUN
включенность	NOUN
вкрадчиво 	ADV
вкусность	NOUN
вкуснятина	NOUN
вкусоароматический	ADJ
влагосвязывающий	ADJ
влагосодержание	NOUN
владикавказский	ADJ
владыкин	ADJ
властно 	ADV
влахернский	ADJ
вложиться	VERB
вломить	VERB
влюбленно 	ADV
вмораживаться	VERB
внаглую 	ADV
вневременной	ADJ
внедорожник	NOUN
внедорожный	ADJ
внезапно 	ADV
внеоборотный	ADJ
внереализационный	ADJ
внестепенной	ADJ
вниманье	NOUN
внимательно 	ADV
внуковский	ADJ
внутрибрюшинный	ADJ
внутривенно 	ADV
внутригрупповой	ADJ
внутрикорпоративный	ADJ
внутримышечно 	ADV
внутрирегиональный	ADJ
внутрироссийский	ADJ
внутрисемейный	ADJ
внутритрубный	ADJ
внутрифирменный	ADJ
внутрихозяйственный	ADJ
внутрицерковный	ADJ
внушительно 	ADV
внятно 	ADV
враждебно 	ADV
вразумительно 	ADV
вредоноснейший	ADJ
временно 	ADV
времяпровождение	NOUN
врубелевский	ADJ
всевозможейший	ADJ
всевозрастающий	ADJ
всеволожский	ADJ
вседорожник	NOUN
всекитайский	ADJ
всемерно 	ADV
всемирно 	ADV
всемирность	NOUN
всенародно 	ADV
всеохватность	NOUN
всеохватный	ADJ
всеохватывающий	ADJ
всесвятой	ADJ
всесезонный	ADJ
всесторонне 	ADV
всеукраинский	ADJ
всецелый	ADJ
всецерковный	ADJ
всечеловечность	NOUN
всклокоченный	ADJ
вспухший	ADJ
встраивание	NOUN
встревоженно 	ADV
встречаемость	NOUN
встроенность	NOUN
встряхивание	NOUN
вторично 	ADV
вторичность	NOUN
второсортность	NOUN
втягивание	NOUN
вуду	NOUN
вульгарнейший	ADJ
вульгарно 	ADV
вусмерть 	ADV
вчерась 	ADV
въедливо 	ADV
выборочно 	ADV
выбраковщик	NOUN
выверенность	NOUN
вывеситься	VERB
выворачивание	NOUN
выгодоприобретатель	NOUN
выгорание	NOUN
выдавливание	NOUN
выделываться	VERB
выдрючиваться	VERB
выдумывание	NOUN
выжидательно 	ADV
выжидающе 	ADV
вызволение	NOUN
выздоравливающий	ADJ
вызывание	NOUN
вызывающе 	ADV
выкопка	NOUN
выкричать	VERB
выксунский	ADJ
вымученно 	ADV
вынашивание	NOUN
вынужденно 	ADV
выпивание	NOUN
выпукло 	ADV
выпячивание	NOUN
выраженье	NOUN
выразительнейший	ADJ
выразительно 	ADV
вырожденный	ADJ
высвечиваться	VERB
высвистнуть	VERB
высоковирулентный	ADJ
высокогорский	ADJ
высокодисперсный	ADJ
высокоинтеллектуальный	ADJ
высоколиквидный	ADJ
высокомерно 	ADV
высокоморальный	ADJ
высокоорганизованный	ADJ
высокопарно 	ADV
высокопреосвященнейший	ADJ
высокопрофессиональный	ADJ
высокопрочный	ADJ
высокорентабельный	ADJ
высокорослый	ADJ
высокотехнологический	ADJ
высокотехнологичный	ADJ
высокоученейший	ADJ
высокоученый	ADJ
высокочистый	ADJ
высочайше 	ADV
высоченнейший	ADJ
выступающий	ADJ
выцарапнуть	VERB
вычурно 	ADV
вышеизложенное	NOUN
вышесказанное	NOUN
вышневолоцкий	ADJ
выщелачивание	NOUN
выщелкиваться	VERB
вэйвлет	NOUN
вязко 	ADV
вяло 	ADV
вялотекущий	ADJ
габровец	NOUN
габсбургский	ADJ
гавриловский	ADJ
гагаринский	ADJ
гагаринский	ADJ
гаданье	NOUN
гаджет	NOUN
гадко 	ADV
гадский	ADJ
гадство	NOUN
гадчайший	ADJ
гадюшник	NOUN
газдановский	ADJ
газогеохимический	ADJ
газодобывающий	ADJ
газодобыча	NOUN
газоконденсатный	ADJ
газоопасный	ADJ
газоперерабатывающий	ADJ
газопотребление	NOUN
газосбережение	NOUN
газотранспортный	ADJ
газпром	NOUN
газпромовский	ADJ
гаишный	ADJ
гайдаровский	ADJ
гайдаровский	ADJ
галантнейший	ADJ
галантно 	ADV
галахический	ADJ
галерейщик	NOUN
галерист	NOUN
галичский	ADJ
галлиполиец	NOUN
галлиполийский	ADJ
галогеновый	ADJ
галстучек	NOUN
гамма-квант	NOUN
ганкелевый	ADJ
гарантирование	NOUN
гарантированно 	ADV
гарлемский	ADJ
гармонически 	ADV
гармонично 	ADV
гастарбайтер	NOUN
гастроэнтерология	NOUN
гатчинский	ADJ
гауляйтер	NOUN
гебист	NOUN
гегелевский	ADJ
гексагидротриазин	NOUN
гексагональный	ADJ
гексоген	NOUN
гелевый	ADJ
гельмголец	NOUN
гемагглютинация	NOUN
гемагглютинин	NOUN
гемагглютинирующий	ADJ
гемокод	NOUN
генацвале	NOUN
гендерный	ADJ
гендиректор	NOUN
генез	NOUN
генерализовать	VERB
генерирование	NOUN
генетически 	ADV
гениальнейший	ADJ
гениально 	ADV
генитальный	ADJ
генконсул	NOUN
генконсульство	NOUN
геновариант	NOUN
геномика	NOUN
геномный	ADJ
генотипирование	NOUN
генотипировать	VERB
генотипический	ADJ
генподрядчик	NOUN
генпрокуратура	NOUN
генпрокурор	NOUN
генсовет	NOUN
генсовет	NOUN
гентамицин	NOUN
генштабовский	ADJ
географически 	ADV
геоданные	ADV
геодинамический	ADJ
геоинформатика	NOUN
геоинформационный	ADJ
геоинформация	NOUN
геомаркетинг	NOUN
геометрически 	ADV
геомеханический	ADJ
геосетка	NOUN
геосистема	NOUN
геосреда	NOUN
геостационарный	ADJ
геостратегический	ADJ
геофак	NOUN
геоэкологический	ADJ
геоэкология	NOUN
геоэкономический	ADJ
геоэлектрический	ADJ
гепарин	NOUN
гепатоцит	NOUN
гепон	NOUN
геранька	NOUN
гербалайф	NOUN
гербера	NOUN
герметически 	ADV
герметично 	ADV
героиновый	ADJ
героически 	ADV
герпесвирус	NOUN
герпесвирусный	ADJ
герпетический	ADJ
герр	NOUN
герценовский	ADJ
гетевский	ADJ
гетерогенность	NOUN
гетерологичный	ADJ
гетероструктура	NOUN
гефсиманский	ADJ
гештальт	NOUN
гиалуроновый	ADJ
гиббереллин	NOUN
гибко 	ADV
гибралтарский	ADJ
гибридизационный	ADJ
гибридомный	ADJ
гибчайший	ADJ
гигакалория	NOUN
гидроавтоматика	NOUN
гидроколлоид	NOUN
гидроксид	NOUN
гидроксил	NOUN
гидроксильный	ADJ
гидроксиэкдизон	NOUN
гидролизат	NOUN
гидромассажный	ADJ
гидромотор	NOUN
гидроразрыв	NOUN
гидросистема	NOUN
гидротермальный	ADJ
гидроциклон	NOUN
гидроцилиндр	NOUN
гинкго	NOUN
гипабиссальный	ADJ
гипервалентный	ADJ
гипервариабельный	ADJ
гипердействительный	ADJ
гипермаркет	NOUN
гиперплоскость	NOUN
гиперсексуальность	NOUN
гиперссылка	NOUN
гипертекст	NOUN
гипертекстовый	ADJ
гиперчувствительность	NOUN
гипоталамус	NOUN
гипотетически 	ADV
гипотиреоз	NOUN
гиппокамп	NOUN
гипсокартон	NOUN
гистограмма	NOUN
гистон	NOUN
гистоновый	ADJ
гитлерюгенд	NOUN
гитлерюгенд	NOUN
главкомат	NOUN
главлит	NOUN
главпочтамт	NOUN
главред	NOUN
главреж	NOUN
главстаршина	NOUN
гладко 	ADV
глажение	NOUN
глайдер	NOUN
гламур	NOUN
гламурный	ADJ
гликозид	NOUN
гликозилирование	NOUN
гликолиз	NOUN
гликопротеин	NOUN
глобализация	NOUN
глобализм	NOUN
глобалист	NOUN
глобалистский	ADJ
глобальнейший	ADJ
глобально 	ADV
глубиннейший	ADJ
глубокомысленно 	ADV
глумливо 	ADV
глуповато 	ADV
глутамин	NOUN
глухо 	ADV
глуховато 	ADV
глушение	NOUN
глушилка	NOUN
глюк	NOUN
глюк	NOUN
глюцилин	NOUN
глючить	VERB
глянуться	VERB
гневно 	ADV
гнесинский	ADJ
гнобить	VERB
гнозис	NOUN
гнусаво 	ADV
гнусно 	ADV
гнусно 	PRED
гоблин	NOUN
говение	NOUN
говенный	ADJ
гоголевский	ADJ
голанский	ADJ
голда	NOUN
голеностоп	NOUN
голимый	ADJ
голицынский	ADJ
головинский	ADJ
головокружительно 	ADV
головоломнейший	ADJ
голословнейший	ADJ
голословно 	ADV
голотип	NOUN
голубовато 	ADV
гольфист	NOUN
гомик	NOUN
гоминид	NOUN
гомогенат	NOUN
гомогенность	NOUN
гомологичный	ADJ
гомосексуал	NOUN
гондон	NOUN
гонконгский	ADJ
горадминистрация	NOUN
горбачевский	ADJ
горбольница	NOUN
горделиво 	ADV
гордо 	ADV
гордума	NOUN
горестно 	ADV
горздрав	NOUN
горизонтально 	ADV
горнозаводский	ADJ
горсуд	NOUN
гортанно 	ADV
горючка	NOUN
горяченький	ADJ
горячительное	NOUN
госавтоинспекция	NOUN
госатомнадзор	NOUN
госбумага	NOUN
госвласть	NOUN
госгарантия	NOUN
госгортехнадзор	NOUN
госграница	NOUN
госдеп	NOUN
госдолг	NOUN
госзаказ	NOUN
госзакупка	NOUN
госимущество	NOUN
госказна	NOUN
госколлекция	NOUN
госкомимущество	NOUN
госкомиссия	NOUN
госкомитет	NOUN
госкомпания	NOUN
госкомстат	NOUN
госконцерт	NOUN
госмонополия	NOUN
госналогслужба	NOUN
госнаркоконтроль	NOUN
госномер	NOUN
гособвинитель	NOUN
гособлигация	NOUN
гособоронзаказ	NOUN
госорган	NOUN
госорганизация	NOUN
госпакет	NOUN
господдержка	NOUN
госпошлина	NOUN
госпремия	NOUN
госрасход	NOUN
госрасходы	NOUN
госрегулирование	NOUN
госсанэпиднадзор	NOUN
госслужащий	NOUN
госслужба	NOUN
госсовет	NOUN
госстандарт	NOUN
госстроительство	NOUN
госструктура	NOUN
гостайна	NOUN
гостевание	NOUN
гостеприимнейший	ADJ
гостеприимно 	ADV
госторгинспекция	NOUN
государственнический	ADJ
государственно 	ADV
государствообразующий	ADJ
госуниверситет	NOUN
госуправление	NOUN
госучреждение	NOUN
госфонд	NOUN
госфункция	NOUN
госчиновник	NOUN
гравилет	NOUN
гравиразведка	NOUN
грамматически 	ADV
граммофончик	NOUN
грамотнейший	ADJ
грамотно 	ADV
гран-при	NOUN
грандиознейший	ADJ
грандиозно 	ADV
гранж	NOUN
гранулометрический	ADJ
графически 	ADV
графовый	ADJ
графоманский	ADJ
грациознейший	ADJ
грациозно 	ADV
гребенец	NOUN
гремучка	NOUN
грешнейший	ADJ
грибоедовский	ADJ
грид	NOUN
гримаска	NOUN
гримерка	NOUN
гримуборная	NOUN
гринкарта	NOUN
грозно 	ADV
громко 	ADV
громогласно 	ADV
громыхание	NOUN
грубо 	ADV
грубовато 	ADV
грузик	NOUN
грузно 	ADV
грузобагаж	NOUN
грузозахватный	ADJ
грузонесущий	ADJ
грузопереработка	NOUN
грунтовый	ADJ
групповуха	NOUN
грустнейший	ADJ
грушинский	ADJ
грязно 	ADV
грязнобородый	ADJ
грязновато 	ADV
губисполком	NOUN
губительнейший	ADJ
губительно 	ADV
губком	NOUN
губревком	NOUN
гудермесский	ADJ
гулко 	ADV
гуляние	NOUN
гуманизация	NOUN
гуманнейший	ADJ
гуманно 	ADV
гумилевский	ADJ
гуппи	NOUN
гурд	NOUN
гурзуфский	ADJ
гусевский	ADJ
гуслицкий	ADJ
густо 	ADV
гутарить	VERB
гутный	ADJ
гэдээровский	ADJ
гэкачепист	NOUN
гэкачепистый	ADJ
давидов	ADJ
дайвер	NOUN
дайвинг	NOUN
даймлер	NOUN
далековато 	ADV
дальновидно 	ADV
дальнодействие	NOUN
даниловский	ADJ
дантовский	ADJ
даос	NOUN
дари	NOUN
даровитейший	ADJ
дартс	NOUN
даун	NOUN
двадцатидвухлетний	ADJ
двадцатиметровый	ADJ
двадцатиминутный	ADJ
двадцатисемилетний	ADJ
двадцатитрехлетний	ADJ
двадцатичетырехлетний	ADJ
двигателестроение	NOUN
движенье	NOUN
дворничка	NOUN
двусмысленно 	ADV
двухкомпонентный	ADJ
двухконтурный	ADJ
двухшереножный	ADJ
дебилизм	NOUN
дебюрократизация	NOUN
деваха	NOUN
девелопер	NOUN
девелоперский	ADJ
девелопмент	NOUN
девиантный	ADJ
девочкин	ADJ
девушкин	ADJ
девятиметровый	ADJ
девятиэтажка	NOUN
дегтярь	NOUN
дезинтеграторный	ADJ
действенно 	ADV
действование	NOUN
декартов	ADJ
декартовский	ADJ
декларант	NOUN
декомпозиция	NOUN
деконструкция	NOUN
декоративка	NOUN
декоративно 	ADV
декорирование	NOUN
делеция	NOUN
деликатнейший	ADJ
деликатно 	ADV
деловито 	ADV
дельнейший	ADJ
дембельский	ADJ
демвыбор	NOUN
деменция	NOUN
демидовский	ADJ
демократически 	ADV
демократичнейший	ADJ
демократично 	ADV
демонстративно 	ADV
дендрограмма	NOUN
деникинский	ADJ
депопуляция	NOUN
депрессионный	ADJ
деприватизация	NOUN
депутатство	NOUN
деревянно 	ADV
дерегулирование	NOUN
державность	NOUN
дерзко 	ADV
дерзновеннейший	ADJ
дерзновенно 	ADV
дерибасовский	ADJ
дерптский	ADJ
десантирование	NOUN
десантировать	VERB
десантироваться	VERB
десталинизация	NOUN
десятидолларовый	ADJ
десятиметровый	ADJ
десятиминутный	ADJ
деталька	NOUN
детальнейший	ADJ
детально 	ADV
детектирование	NOUN
детектировать	VERB
детекция	NOUN
детергент	NOUN
деткомбинат	NOUN
детройтский	ADJ
дефендер	NOUN
дефицитнейший	ADJ
дефлятор	NOUN
дешевейший	ADJ
дешифрирование	NOUN
деятельнейший	ADJ
деятельно 	ADV
деятельностный	ADJ
джазмен	NOUN
джинса	NOUN
джунгарский	ADJ
дзенский	ADJ
дзержинец	NOUN
дзынь 	INTJ
диагностикум	NOUN
диагностирование	NOUN
диазапентадиен	NOUN
диалектически 	ADV
диафрагмальный	ADJ
диахронический	ADJ
дивеевский	ADJ
диверсифицировать	VERB
дивно 	ADV
дивно 	PRED
дидактический	ADJ
дизтопливо	NOUN
диккенсовский	ADJ
диковато 	ADV
дикорос	NOUN
дилатансионный	ADJ
димерный	ADJ
динамически 	ADV
динамично 	ADV
диодный	ADJ
диоксид	NOUN
диплоидный	ADJ
дипломатически 	ADV
дипломатично 	ADV
директивно 	ADV
дирижирование	NOUN
дискоклуб	NOUN
дискретно 	ADV
дискриминантный	ADJ
диснеевский	ADJ
диспаритет	NOUN
диспергирование	NOUN
диспозитивность	NOUN
диспозитивный	ADJ
диссидентство	NOUN
диссипативный	ADJ
диссипация	NOUN
диссоциировать	VERB
дистальный	ADJ
дистанционно 	ADV
дистанцирование	NOUN
дистанцировать	VERB
дистония	NOUN
дистрибутор	NOUN
дистрибьюторский	ADJ
дистрибьюция	NOUN
дисциплинированно 	ADV
дифференциально 	ADV
дифференцированно 	ADV
дифференцировка	NOUN
дичайший	ADJ
длинно 	ADV
длинномерный	ADJ
длительно 	ADV
дмитриевский	ADJ
дмитровский	ADJ
добивание	NOUN
доблестнейший	ADJ
доблестно 	ADV
добровольно 	ADV
добродушнейший	ADJ
добродушно 	ADV
доброжелательнейший	ADJ
доброжелательно 	ADV
добросовестнейший	ADJ
добросовестно 	ADV
добротнейший	ADJ
добротно 	ADV
добротолюбие	NOUN
добычинский	ADJ
добычный	ADJ
доверительно 	ADV
доверчиво 	ADV
довлатовский	ADJ
догматически 	ADV
додавить	VERB
додо	NOUN
дозирование	NOUN
дознаватель	NOUN
доиндустриальный	ADJ
дойкий	ADJ
доказательно 	ADV
доказывание	NOUN
доклинический	ADJ
докорм	NOUN
докризисный	ADJ
докторишка	NOUN
документально 	ADV
документарный	ADJ
документик	NOUN
документооборот	NOUN
докучнейший	ADJ
долбаный	ADJ
долбаться	VERB
долбиться	VERB
долговский	ADJ
долгопрудненский	ADJ
долма	NOUN
домовитейший	ADJ
домодедовский	ADJ
домонгольский	ADJ
донорный	ADJ
дооценка	NOUN
допирать	VERB
доплеровский	ADJ
доподлиннейший	ADJ
доползаться	VERB
допэмиссия	NOUN
доработчик	NOUN
доразведка	NOUN
дорогомиловский	ADJ
дорогущий	ADJ
досадливо 	ADV
досконально 	ADV
дословно 	ADV
доснять	VERB
досочка	NOUN
досрочно 	ADV
доставочный	ADJ
достигнутое	NOUN
достовернейший	ADJ
достоверно 	ADV
достойно 	ADV
доступно 	ADV
досуговый	ADJ
досудебный	ADJ
досчет	NOUN
дотирование	NOUN
дотопать	VERB
дотошнейший	ADJ
дотошно 	ADV
доукомплектование	NOUN
дофамин	NOUN
доходнейший	ADJ
доходчиво 	ADV
драглайн	NOUN
драгметалл	NOUN
дракончик	NOUN
драматически 	ADV
драматично 	ADV
древлянский	ADJ
древневосточный	ADJ
древнегерманский	ADJ
дремучесть	NOUN
дринк	NOUN
дробно 	ADV
дроздовец	NOUN
дроздовский	ADJ
друган	NOUN
дружбан	NOUN
дружелюбно 	ADV
дружественно 	ADV
дружно 	ADV
дрын	NOUN
дубненец	NOUN
дубненский	ADJ
дувал	NOUN
дудаевец	NOUN
дудаевский	ADJ
дурашливо 	ADV
дурка	NOUN
дурошлеп	NOUN
духовно 	ADV
душевно 	ADV
дымно 	ADV
дырочный	ADJ
дыханье	NOUN
дэвидский	ADJ
дягилевский	ADJ
дядик	NOUN
еврейчик	NOUN
евроазиатский	ADJ
евроатлантический	ADJ
евробонд	NOUN
еврозона	NOUN
евролига	NOUN
еврооблигация	NOUN
европарламент	NOUN
евроремонт	NOUN
евростандарт	NOUN
евротур	NOUN
евтушенковед	NOUN
егорьевский	ADJ
единично 	ADV
единовременно 	ADV
единогласно 	ADV
единодушно 	ADV
единолично 	ADV
единообразно 	ADV
единоросс	NOUN
единственно 	ADV
единственность	NOUN
едко 	ADV
ежевечерне 	ADV
ежегодно 	ADV
ежедневно 	ADV
ежеквартально 	ADV
ежемесячно 	ADV
еженедельно 	ADV
еженощно 	ADV
ежесекундно 	ADV
ежесуточно 	ADV
ежечасно 	ADV
ежовский	ADJ
ежовщина	NOUN
ездун	NOUN
ейский	ADJ
елагинец	NOUN
елейно 	ADV
елеонский	ADJ
елисаветинский	ADJ
елоховский	ADJ
ельцинский	ADJ
емко 	ADV
ермоловский	ADJ
ерничество	NOUN
ерофеевский	ADJ
ессей	NOUN
естественноисторический	ADJ
ефремовский	ADJ
ехидно 	ADV
жаднейший	ADJ
жадно 	ADV
жалобно 	ADV
жалостливо 	ADV
жалостно 	ADV
жарковатый	ADJ
жарочный	ADJ
жгуче 	ADV
ждановский	ADJ
жевун	NOUN
желаннейший	ADJ
желанье	NOUN
железно 	ADV
желтейший	ADJ
желудочковый	ADJ
желчно 	ADV
жеманно 	ADV
женственно 	ADV
жердяй	NOUN
жертвенно 	ADV
жестко 	ADV
жестчайший	ADJ
живо 	ADV
живоначальный	ADJ
живоносный	ADJ
живописнейший	ADJ
живописно 	ADV
жигуль	NOUN
жиденок	NOUN
жидко 	ADV
жизненно 	ADV
жизнерадостно 	ADV
жилкование	NOUN
жилкомхоз	NOUN
жириновец	NOUN
жиркомбинат	NOUN
жирно 	ADV
жирно 	PRED
житейски 	ADV
жлобство	NOUN
жопа	NOUN
жужжанье	NOUN
журналюга	NOUN
журфак	NOUN
журчанье	NOUN
жутчайший	ADJ
забавно 	ADV
забвенье	NOUN
заблужденье	NOUN
заботливо 	ADV
забугорный	ADJ
забытейший	ADJ
забытие	NOUN
зависание	NOUN
зависимо 	ADV
завистливо 	ADV
завладение	NOUN
заводчанин	NOUN
завораживающе 	ADV
завороженно 	ADV
завороженность	NOUN
завотделением	NOUN
заврик	NOUN
загадочнейший	ADJ
загадочно 	ADV
заглядывание	NOUN
заговорщицки 	ADV
заговорщически 	ADV
загончик	NOUN
загоризонтный	ADJ
заградотряд	NOUN
загуливаться	VERB
заданность	NOUN
задействование	NOUN
задекларировать	VERB
задиристо 	ADV
заднебоковой	ADJ
заднегрудь	NOUN
заднелатеральный	ADJ
заднеприводной	ADJ
задокументировать	VERB
задолбать	VERB
задорнейший	ADJ
задорно 	ADV
задумчиво 	ADV
задушевнейший	ADJ
задушевно 	ADV
зажатость	NOUN
зазвонный	ADJ
заземлитель	NOUN
заинтересованно 	ADV
заискивающе 	ADV
заказуха	NOUN
закапчиваться	VERB
закипание	NOUN
заклятье	NOUN
законнейший	ADJ
законно 	ADV
законодательно 	ADV
закономерно 	ADV
законопачиваться	VERB
законопослушание	NOUN
законопослушность	NOUN
законотворец	NOUN
законченнейший	ADJ
закордонный	ADJ
закрывание	NOUN
закрытость	NOUN
закрытье	NOUN
заксобрание	NOUN
закулисье	NOUN
заливисто 	ADV
залихватски 	ADV
заломать	VERB
зальчик	NOUN
заманчиво 	ADV
заматериться	VERB
замгендиректора	NOUN
замгенпрокурора	NOUN
замглавы	NOUN
замглавы	NOUN
замедленно 	ADV
заметнейший	ADJ
заметность	NOUN
замечательнейший	ADJ
замечательно 	ADV
замкнуто 	ADV
замминистра	NOUN
замначальника	NOUN
заморачиваться	VERB
заморозиться	VERB
заморочиться	VERB
замруководителя	NOUN
замурзанный	ADJ
замысловатейший	ADJ
замысловато 	ADV
замятинский	ADJ
занавесочка	NOUN
занимательнейший	ADJ
заносчиво 	ADV
зануднейший	ADJ
заныкать	VERB
заныривать	VERB
занырнуть	VERB
занюхать	VERB
занюхивать	VERB
занятнейший	ADJ
занятно 	ADV
заозираться	VERB
заоконный	ADJ
заочно 	ADV
западло 	PRED
запальчиво 	ADV
запечатление	NOUN
запирательный	ADJ
заповеднейший	ADJ
заполняемость	NOUN
заполошно 	ADV
запредельно 	ADV
запретнейший	ADJ
запульсировать	VERB
запутаннейший	ADJ
зарабатывание	NOUN
заразительнейший	ADJ
заразительно 	ADV
заразнейший	ADJ
зарплатный	ADJ
зарядовый	ADJ
засилие	NOUN
заслуженнейший	ADJ
заслуженно 	ADV
засранец	NOUN
застенчиво 	ADV
заступление	NOUN
затаенно 	ADV
затариться	VERB
затейливо 	ADV
затравленно 	ADV
затратный	ADJ
затруднительно 	ADV
зауважать	VERB
заунывно 	ADV
зауряднейший	ADJ
заученно 	ADV
захлебать	VERB
заценить	VERB
зацикленность	NOUN
зачарованно 	ADV
зачатки	NOUN
зачаточно 	ADV
защитность	NOUN
заюшка	NOUN
заявительный	ADJ
звездность	NOUN
звонко 	ADV
звучно 	ADV
зданье	NOUN
здоровеннейший	ADJ
здраво 	ADV
зековский	ADJ
зелено 	PRED
зеленовато 	ADV
зеленоградский	ADJ
зеленомошниковый	ADJ
зелепукинский	ADJ
земеля	NOUN
землеотвод	NOUN
зеркально 	ADV
зернобобовый	ADJ
зиновьевец	NOUN
зиновьевский	ADJ
златоустовский	ADJ
златоустый	ADJ
злобнейший	ADJ
злобно 	ADV
злободневнейший	ADJ
зловеще 	ADV
зловоннейший	ADJ
злорадно 	ADV
злостно 	ADV
змеюка	NOUN
знаковость	NOUN
знакомо 	ADV
знаменательнейший	ADJ
знаменитейший	ADJ
знанье	NOUN
значимо 	ADV
значительнейший	ADJ
зовиракс	NOUN
золотаревский	ADJ
золотодобытчик	NOUN
золотодобыча	NOUN
золотозубый	ADJ
золоторудный	ADJ
зомбирование	NOUN
зондеркоманда	NOUN
зондовый	ADJ
зонирование	NOUN
зорко 	ADV
зороастриец	NOUN
зрело 	ADV
зримо 	ADV
зрительно 	ADV
зряшно 	ADV
зудильник	NOUN
зуевский	ADJ
зыбко 	ADV
зычно 	ADV
зюгановец	NOUN
зюгановский	ADJ
зябко 	ADV
ибраевский	ADJ
ивашниковский	ADJ
ивритский	ADJ
игарский	ADJ
игриво 	ADV
идеальнейший	ADJ
идеально 	ADV
идейно 	ADV
идентификатор	NOUN
идентификационный	ADJ
идеологема	NOUN
идеологизировать	VERB
идеологически 	ADV
идиотски 	ADV
идолец	NOUN
иерархически 	ADV
иерархичность	NOUN
иеросхимонах	NOUN
избегание	NOUN
избирательно 	ADV
избирком	NOUN
избитейший	ADJ
избраннейший	ADJ
избыточно 	ADV
известинский	ADJ
извещатель	NOUN
извращенка	NOUN
изгнанье	NOUN
издевательски 	ADV
излишне 	ADV
излучательный	ADJ
излюбленнейший	ADJ
изм	NOUN
измерительно 	ADV
изначально 	ADV
изобразительно 	ADV
изобретательнейший	ADJ
изобретательно 	ADV
изолированно 	ADV
изощреннейший	ADJ
изощренно 	ADV
израилев	ADJ
изряднейший	ADJ
изрядно 	ADV
изумительнейший	ADJ
изумительно 	ADV
изумленно 	ADV
изумрудно 	ADV
изучающе 	ADV
изысканнейший	ADJ
изысканно 	ADV
изящно 	ADV
иисусов	ADJ
иксодовый	ADJ
илимский	ADJ
иллюстративно 	ADV
ильюшинец	NOUN
ильюшинский	ADJ
именитейший	ADJ
именье	NOUN
имидазол	NOUN
имидазолин	NOUN
имиджевый	ADJ
имиджмейкер	NOUN
имитационно 	ADV
имманентно 	ADV
иммунобиологический	ADJ
иммуноблот	NOUN
иммуноблоттинг	NOUN
иммуногенность	NOUN
иммуногенный	ADJ
иммуноглобулин	NOUN
иммунодоминантный	ADJ
иммунокомпетентный	ADJ
иммуномодулирующий	ADJ
иммуномодулятор	NOUN
иммунореактивность	NOUN
иммунореактивный	ADJ
иммуносупрессивный	ADJ
иммуносупрессия	NOUN
иммуноферментный	ADJ
иммунофлюоресцентный	ADJ
иммунофлюоресценция	NOUN
иммунохимический	ADJ
имплант	NOUN
имплантант	NOUN
имплантат	NOUN
имплицировать	VERB
имплицитно 	ADV
имплицитный	ADJ
импортозамещающий	ADJ
импортозамещение	NOUN
импортозамещенный	ADJ
импровизационно 	ADV
имхо 	PARENTH
инаковость	NOUN
инактивация	NOUN
инактивировать	VERB
инверсионно 	ADV
инвестирование	NOUN
инвестиционно 	ADV
инвесткомпания	NOUN
инвестпрограмма	NOUN
ингерманландский	ADJ
ингибирование	NOUN
ингибировать	VERB
ингибиторный	ADJ
ингибиция	NOUN
индексирование	NOUN
индивидный	ADJ
индивидуально 	ADV
индивидуация	NOUN
индикация	NOUN
индульгирование	NOUN
индустриальнейший	ADJ
индустриально 	ADV
инертно 	ADV
инерциальный	ADJ
инерционно 	ADV
инерционность	NOUN
инет	NOUN
инжиниринг	NOUN
инжиниринговый	ADJ
инициализация	NOUN
инициативно 	ADV
инициирование	NOUN
инкассовый	ADJ
инкубаторский	ADJ
инкубирование	NOUN
иннервировать	VERB
инновационно 	ADV
иное	NOUN
иносказательно 	ADV
иноходка	NOUN
инсайдерский	ADJ
инстабильность	NOUN
инстинктивно 	ADV
институционализация	NOUN
институционально 	ADV
институциональный	ADJ
инструктивно 	ADV
инструментально 	ADV
интактный	ADJ
интегративный	ADJ
интеграционно 	ADV
интегрированность	NOUN
интеллектуализация	NOUN
интеллектуальнейший	ADJ
интеллектуально 	ADV
интеллектуальность	NOUN
интеллигентик	NOUN
интеллигентнейший	ADJ
интеллигентно 	ADV
интенсивнейший	ADJ
интенсивно 	ADV
интенционально 	ADV
интенциональность	NOUN
интенциональный	ADJ
интерактивность	NOUN
интервальный	ADJ
интересненький	ADJ
интересность	NOUN
интермедиат	NOUN
интермодальный	ADJ
интернационально 	ADV
интернетовский	ADJ
интерпретационный	ADJ
интерпсихический	ADJ
интертекст	NOUN
интерференционный	ADJ
интерфероновый	ADJ
интерчемпион	NOUN
интимнейший	ADJ
интимно 	ADV
интифада	NOUN
интонационно 	ADV
интраназальный	ADJ
интрапсихический	ADJ
интрацеребральный	ADJ
интригующе 	ADV
интригующий	ADJ
интродуцент	NOUN
интродуцировать	VERB
интрузивно 	ADV
интуитивно 	ADV
интуристовский	ADJ
инфа	NOUN
инфекционность	NOUN
инфернальность	NOUN
инферно	NOUN
инфицирование	NOUN
инфицированность	NOUN
информагентство	NOUN
информативность	NOUN
информатизация	NOUN
информационно 	ADV
инфраструктурный	ADJ
инфрастуктура	NOUN
иньский	ADJ
иоаннов	ADJ
иоанновский	ADJ
ипатьевский	ADJ
ипподромный	ADJ
иронически 	ADV
иронично 	ADV
иррационально 	ADV
искательно 	ADV
исключенье	NOUN
исковый	ADJ
исконно 	ADV
искренне 	ADV
искреннейший	ADJ
искренно 	ADV
искристо 	ADV
искуснейший	ADJ
искусно 	ADV
искусственно 	ADV
исповедничество	NOUN
исполненный	ADJ
исполнительно 	ADV
исправнейший	ADJ
исправно 	ADV
испуганно 	ADV
испытаннейший	ADJ
испытующе 	ADV
исступленно 	ADV
истерично 	ADV
истинно 	ADV
истирание	NOUN
истово 	ADV
истопка	NOUN
историософия	NOUN
историософский	ADJ
исторически 	ADV
истошно 	ADV
истощаемость	NOUN
исходник	NOUN
исцеленье	NOUN
исчезающе 	ADV
исчерпание	NOUN
исчерпывающе 	ADV
итерационный	ADJ
иудаист	NOUN
ичкерийский	ADJ
ишимский	ADJ
йельский	ADJ
каббалист	NOUN
кабинетик	NOUN
кабинетнейший	ADJ
кавбригада	NOUN
каверзнейший	ADJ
кавкорпус	NOUN
кавээнщик	NOUN
кагоцел	NOUN
кадавр	NOUN
кадарский	ADJ
кадрик	NOUN
кадыровский	ADJ
казахстанец	NOUN
казеннейший	ADJ
кайфовейший	ADJ
кайфовый	ADJ
какашка	NOUN
калаш	NOUN
калашный	ADJ
калицивирус	NOUN
каменноостровский	ADJ
камерность	NOUN
камовский	ADJ
каналец	NOUN
канамицин	NOUN
канатик	NOUN
каннский	ADJ
канонически 	ADV
кантовский	ADJ
капвложения	NOUN
капитальнейший	ADJ
капитально 	ADV
капризнейший	ADJ
капризно 	ADV
капуччино	NOUN
каракумский	ADJ
карамзинский	ADJ
карбонитрид	NOUN
кардиальный	ADJ
кардинальнейший	ADJ
кардинально 	ADV
карикатурно 	ADV
кармадонский	ADJ
кармический	ADJ
каролингский	ADJ
каросский	ADJ
каротиноид	NOUN
каррагинан	NOUN
карри	NOUN
картинно 	ADV
картиночка	NOUN
картоха	NOUN
касимовский	ADJ
кастинг	NOUN
касьяновский	ADJ
катаевский	ADJ
катакомбный	ADJ
каталка	NOUN
катапультирование	NOUN
катапультный	ADJ
катарский	ADJ
катастрофически 	ADV
категоризация	NOUN
категорически 	ADV
категорично 	ADV
катионный	ADJ
катынский	ADJ
кафешка	NOUN
качественно 	ADV
качканарский	ADJ
качок	NOUN
квадратический	ADJ
квазистационарный	ADJ
квалифицированнейший	ADJ
квалифицированно 	ADV
квантовохимический	ADJ
квантодетерминированный	ADJ
квантунский	ADJ
кватроченто	NOUN
квотный	ADJ
келейно 	ADV
кембриджский	ADJ
кенигсбергский	ADJ
кепочка	NOUN
кепчонка	NOUN
керамист	NOUN
керлинг	NOUN
кероген	NOUN
кидала	NOUN
кикбоксер	NOUN
кимрский	ADJ
кинельский	ADJ
кинешемский	ADJ
киноакадемия	NOUN
киногерой	NOUN
киногруппа	NOUN
киноман	NOUN
кинопоказ	NOUN
кинопродукция	NOUN
кинофорум	NOUN
киношкола	NOUN
киотский	ADJ
кирзач	NOUN
киркенесский	ADJ
кисанька	NOUN
киселевский	ADJ
кисло 	ADV
кич	NOUN
клайпедский	ADJ
классически 	ADV
класснейший	ADJ
классно 	ADV
классно 	PART
классно 	PRED
кластеризация	NOUN
кластерный	ADJ
клацнуть	VERB
клево 	ADV
клематис	NOUN
кликуха	NOUN
климовский	ADJ
клинически 	ADV
клипмейкер	NOUN
клипсатор	NOUN
клиренс	NOUN
клофелин	NOUN
клошар	NOUN
клювовидный	ADJ
клятвенно 	ADV
кнедлик	NOUN
книгоиздание	NOUN
княгинюшка	NOUN
князишка	NOUN
князюшка	NOUN
коаксиальный	ADJ
ковалентный	ADJ
коварнейший	ADJ
коварно 	ADV
ковдорский	ADJ
ковровский	ADJ
ковролин	NOUN
ковылкинский	ADJ
когдатошний	ADJ
когнитивный	ADJ
кодировка	NOUN
кодон	NOUN
козельский	ADJ
кокетливо 	ADV
коккер	NOUN
кокпит	NOUN
коктебельский	ADJ
колбасить	VERB
колбаситься	VERB
количественно 	ADV
коллагеновый	ADJ
коллагенсодержащий	ADJ
коллегиально 	ADV
коллективно 	ADV
коллекторский	ADJ
колонновидный	ADJ
колор	NOUN
колористика	NOUN
колоритнейший	ADJ
колоссальнейший	ADJ
колоссально 	ADV
колумнист	NOUN
кольцовский	ADJ
колюче 	ADV
колючейший	ADJ
команданте	NOUN
комариха	NOUN
комаровский	ADJ
комически 	ADV
комично 	ADV
коммент	NOUN
комментирование	NOUN
коммерчески 	ADV
коммоция	NOUN
коммунарский	ADJ
коммуникатор	NOUN
коммунистически 	ADV
коммуняка	NOUN
комнатуха	NOUN
компакт	NOUN
компактно 	ADV
компакция	NOUN
компашка	NOUN
компенсаторный	ADJ
компенсирующий	ADJ
компетентно 	ADV
комплексирование	NOUN
комплексно 	ADV
композит	NOUN
композиционно 	ADV
компрессик	NOUN
комроты	NOUN
комстат	NOUN
комфортабельно 	ADV
комфортнейший	ADJ
комфортно 	ADV
комфортно 	PRED
комфортность	NOUN
конаковский	ADJ
конвективный	ADJ
конверсив	NOUN
кондовейший	ADJ
конкретнейший	ADJ
конкретно 	ADV
конкурсантка	NOUN
конопушка	NOUN
консенсусный	ADJ
консервативнейший	ADJ
консервативно 	ADV
конситуативный	ADJ
конспирологический	ADJ
константиновский	ADJ
конституционно 	ADV
конституционность	NOUN
конструктивно 	ADV
контактор	NOUN
контекстный	ADJ
контент	NOUN
континуальный	ADJ
контраргумент	NOUN
контрастно 	ADV
контрафактный	ADJ
контрацептив	NOUN
контрейлер	NOUN
контрейлерный	ADJ
контрик	NOUN
контрольная	NOUN
контрпродуктивный	ADJ
контрразведывательный	ADJ
контрреформа	NOUN
контртеррористический	ADJ
конфиденциально 	ADV
конфиденциальность	NOUN
конфисковывать	VERB
конфликтнейший	ADJ
конфликтность	NOUN
конформационный	ADJ
конформация	NOUN
конформер	NOUN
концентратор	NOUN
концентрирование	NOUN
концентрически 	ADV
концептуализация	NOUN
концептуально 	ADV
конъюгат	NOUN
коняшка	NOUN
кооперационный	ADJ
копирайтер	NOUN
копринус	NOUN
коптевский	ADJ
коранический	ADJ
корецептор	NOUN
коровинский	ADJ
коротенько 	ADV
короткоствольный	ADJ
корпоративно 	ADV
корректива	NOUN
корректнейший	ADJ
корректно 	ADV
коррекционный	ADJ
коррумпированность	NOUN
кортизол	NOUN
коршуновский	ADJ
корявейший	ADJ
коряво 	ADV
космизм	NOUN
космически 	ADV
космодемьянский	ADJ
космоплан	NOUN
космоснимок	NOUN
косо 	ADV
косовский	ADJ
косолапо 	ADV
коспонсор	NOUN
костылек	NOUN
котельнический	ADJ
котлоагрегат	NOUN
котовец	NOUN
коттеджик	NOUN
коттеджный	ADJ
коттон	NOUN
кофий	NOUN
кошмарнейший	ADJ
кошмарно 	ADV
кощунственно 	ADV
крабий	ADJ
крайизбирком	NOUN
крамбол	NOUN
кранты 	PRED
краповый	ADJ
красиво 	ADV
красивоцветущий	ADJ
красик	NOUN
красинский	ADJ
красновато 	ADV
красногорский	ADJ
краснокирпичный	ADJ
краснокутский	ADJ
краснолистный	ADJ
краснопресненский	ADJ
красноречивейший	ADJ
красноречиво 	ADV
красносельский	ADJ
красочно 	ADV
кратко 	ADV
кратковременно 	ADV
краунсодержащий	ADJ
креатив	NOUN
креативность	NOUN
креативный	ADJ
креатор	NOUN
крейслейтер	NOUN
кремнийорганический	ADJ
крестовец	NOUN
крестообразно 	ADV
крещенье	NOUN
кривейший	ADJ
кривляние	NOUN
криво 	ADV
крикливо 	ADV
криминалитет	NOUN
криптомелан	NOUN
кристалловский	ADJ
кристальнейший	ADJ
кристально 	ADV
критериальный	ADJ
критикесса	NOUN
критически 	ADV
критично 	ADV
кровавейший	ADJ
кроваво 	ADV
кровно 	ADV
кровожадно 	ADV
кровопролитнейший	ADJ
кровоснабжаемый	ADJ
кровоток	NOUN
крокодильчик	NOUN
кропоткинский	ADJ
кропотливейший	ADJ
кротко 	ADV
кротчайший	ADJ
круассан	NOUN
кругаль	NOUN
круглейший	ADJ
кругло 	ADV
круглогодично 	ADV
круглосуточно 	ADV
круизный	ADJ
крупно 	ADV
крупность	NOUN
крупноцветковый	ADJ
крупняк	NOUN
крутейший	ADJ
крутицкий	ADJ
круто 	ADV
крутящий	ADJ
круцин	NOUN
крылатский	ADJ
крыловидный	ADJ
крышевание	NOUN
крышной	ADJ
крышный	ADJ
крэк	NOUN
крючковидный	ADJ
кряшен	NOUN
ксеноновый	ADJ
ксенофоб	NOUN
ксенофобский	ADJ
ксерион	NOUN
ксива	NOUN
кубло	NOUN
кудринский	ADJ
куединский	ADJ
кузбасский	ADJ
кузнецовский	ADJ
кузьминский	ADJ
кул 	INTJ
кулемка	NOUN
куликовский	ADJ
кулоновский	ADJ
культбригада	NOUN
культуральный	ADJ
культурнейший	ADJ
культурно 	ADV
кунгурский	ADJ
кундалини	NOUN
купавинский	ADJ
курай	NOUN
курирование	NOUN
курляндский	ADJ
курский	ADJ
курчатовский	ADJ
курьезнейший	ADJ
кустарнейший	ADJ
кустодиевский	ADJ
куттер	NOUN
кутузовский	ADJ
кучно 	ADV
кыргызский	ADJ
кэптивный	ADJ
кэш	NOUN
лабинский	ADJ
лабораторно 	ADV
лабуда	NOUN
лабух	NOUN
лавинообразно 	ADV
лавэ	NOUN
лагпункт	NOUN
ладненько 	ADV
ладненько 	PART
лазание	NOUN
лазаревский	ADJ
лайм	NOUN
лайнбекер	NOUN
лаконично 	ADV
лактостаз	NOUN
ламер	NOUN
ламинат	NOUN
ламия	NOUN
ландшафтник	NOUN
лансер	NOUN
лантаноид	NOUN
ласково 	ADV
латание	NOUN
латинос	NOUN
лауреатство	NOUN
левинский	ADJ
леволиберальный	ADJ
левопатриотический	ADJ
легально 	ADV
легирование	NOUN
легитимизация	NOUN
легитимизировать	VERB
легитимно 	ADV
легкомысленно 	ADV
легкосплавный	ADJ
лего	NOUN
лежкий	ADJ
лежкость	NOUN
лейбл	NOUN
лейкозный	ADJ
лейтенантик	NOUN
лексус	NOUN
лектотип	NOUN
лениво 	ADV
лентяйский	ADJ
леонтьевский	ADJ
лепин	NOUN
лесоводственный	ADJ
лесовозобновление	NOUN
лесовосстановительный	ADJ
лесовосстановление	NOUN
лесовыращивание	NOUN
лесоинвентаризация	NOUN
лесокультурный	ADJ
лесопатологический	ADJ
лесоперерабатывающий	ADJ
лесопожарный	ADJ
лесопользование	NOUN
лесопользователь	NOUN
лесорастительный	ADJ
лесосеменной	ADJ
лесосырьевой	ADJ
лесотаксационный	ADJ
лесоуправление	NOUN
лесоустроитель	NOUN
лесохозяйственный	ADJ
леспромхозовский	ADJ
лествица	NOUN
летоисчисление	NOUN
лефортовский	ADJ
лживо 	ADV
лианозовский	ADJ
либерализовать	VERB
либерально 	ADV
лиганд	NOUN
лиганд	NOUN
лизат	NOUN
лизингодатель	NOUN
лизингополучатель	NOUN
лизировать	VERB
лизирующий	ADJ
ликвор	NOUN
ликующе 	ADV
лилейник	NOUN
лимоновец	NOUN
лимфобластоидный	ADJ
лимфодренаж	NOUN
лимфоидный	ADJ
лимфоузел	NOUN
линеамент	NOUN
линейно 	ADV
линк	NOUN
лиофилизировать	VERB
липид	NOUN
липидный	ADJ
липко 	ADV
липосакция	NOUN
липосома	NOUN
лирически 	ADV
лиственничник	NOUN
листинг	NOUN
листрический	ADJ
литавра	NOUN
литературка	NOUN
литературно 	ADV
литинститут	NOUN
литобъединенец	NOUN
литол	NOUN
литологический	ADJ
литосферный	ADJ
литсотрудник	NOUN
литфондовский	ADJ
лифтинг	NOUN
лифтостроительный	ADJ
лихорадочно 	ADV
лицемерно 	ADV
лицензиар	NOUN
лицензиат	NOUN
лично 	ADV
личностно 	ADV
лобстер	NOUN
логистический	ADJ
логически 	ADV
логично 	ADV
логопсихотерапия	NOUN
лодзинский	ADJ
ложноположительный	ADJ
локально 	ADV
ломакинский	ADJ
ломануться	VERB
ломоносовский	ADJ
лонгитюдный	ADJ
лопухнуться	VERB
лосиноостровский	ADJ
лояльно 	ADV
лубянский	ADJ
луганский	ADJ
луговский	ADJ
лужковский	ADJ
лужниковский	ADJ
лукаво 	ADV
луковский	ADJ
лукойловский	ADJ
лучезапястный	ADJ
лучезарно 	ADV
лыбиться	VERB
льговский	ADJ
льдистость	NOUN
льдогенератор	NOUN
льноволосый	ADJ
льстиво 	ADV
любезно 	ADV
любимейший	ADJ
любимейший	ADJ
любименький	ADJ
любимовский	ADJ
люблинский	ADJ
любовно 	ADV
людиновский	ADJ
люто 	ADV
лючок	NOUN
лязганье	NOUN
лялечка	NOUN
лям	NOUN
лян	NOUN
магически 	ADV
магнетитовый	ADJ
магнетосопротивление	NOUN
магнитооптический	ADJ
магнум	NOUN
маечка	NOUN
мазда	NOUN
мазератти	NOUN
мазохистский	ADJ
майкопский	ADJ
майнинг	NOUN
макак	NOUN
макарьевский	ADJ
макрорегион	NOUN
макроуровень	NOUN
макроэкономика	NOUN
максимально 	ADV
максимизация	NOUN
максимизировать	VERB
малаховский	ADJ
малгобекский	ADJ
малоберцовый	ADJ
малобюджетный	ADJ
маловатый	ADJ
маловысотный	ADJ
малодушно 	ADV
малозатратный	ADJ
малообеспеченный	ADJ
малоприметный	ADJ
малоприятнейший	ADJ
малосимпатичный	ADJ
малохольный	ADJ
малоярославецкий	ADJ
мальчиш	NOUN
малява	NOUN
мамашка	NOUN
мамонтенок	NOUN
мандала	NOUN
мандельштамовский	ADJ
манерно 	ADV
маниакально 	ADV
манипулирование	NOUN
манипулятивный	ADJ
манхэттенский	ADJ
манюня	NOUN
мар	NOUN
маргинал	NOUN
маргинализация	NOUN
маргинальнейший	ADJ
маргинальность	NOUN
мариинский	ADJ
маркет	NOUN
маркетолог	NOUN
марковец	NOUN
марковский	ADJ
марксов	ADJ
марлин	NOUN
марран	NOUN
мартель	NOUN
марфинский	ADJ
маршрутизатор	NOUN
марьинский	ADJ
маскирование	NOUN
маскулинность	NOUN
маскулинный	ADJ
маслянисто 	ADV
масляно 	ADV
массандровский	ADJ
массивнейший	ADJ
массирование	NOUN
масскульт	NOUN
массово 	ADV
массогабаритный	ADJ
массоперенос	NOUN
мастер-класс	NOUN
масхадовский	ADJ
масштабирование	NOUN
масштабнейший	ADJ
масштабно 	ADV
матвеевский	ADJ
математически 	ADV
материально 	ADV
матерно 	ADV
матерьяльный	ADJ
матово 	ADV
матюги	NOUN
матюк	NOUN
махараджа	NOUN
махатма	NOUN
машзавод	NOUN
машинально 	ADV
машинокомплект	NOUN
машиноместо	NOUN
мгновенно 	ADV
мгновенность	NOUN
мгновенье	NOUN
мебельщик	NOUN
мегапарсек	NOUN
мегапроект	NOUN
медиамагнат	NOUN
медиарынок	NOUN
медиасоюз	NOUN
медийный	ADJ
мединский	ADJ
медитативнейший	ADJ
медитировать	VERB
медицински 	ADV
медленно 	ADV
медлительно 	ADV
медучилище	NOUN
медучреждение	NOUN
межбюджетный	ADJ
межгород	NOUN
межгрупповой	ADJ
межклубный	ADJ
межкультурный	ADJ
межмуниципальный	ADJ
межосевой	ADJ
межпереписной	ADJ
межрелигиозный	ADJ
межфазный	ADJ
межцивилизационный	ADJ
межэтнический	ADJ
мезотерапия	NOUN
мезофаза	NOUN
мейерхольдовский	ADJ
мейл	NOUN
мейнстрим	NOUN
меланофор	NOUN
меланхолически 	ADV
меланхолично 	ADV
мелатонин	NOUN
меленько 	ADV
мелирование	NOUN
мелиховский	ADJ
мелко 	ADV
мелкодисперсный	ADJ
мелодично 	ADV
мелочевка	NOUN
мембранозный	ADJ
мемуар	NOUN
менделеевский	ADJ
менингоэнцефалит	NOUN
мент	NOUN
ментовка	NOUN
ментовский	ADJ
ментура	NOUN
мерзко 	ADV
мерзопакостнейший	ADJ
мерзостнейший	ADJ
мерно 	ADV
мерс	NOUN
мерс	NOUN
мерседесовский	ADJ
мертвейший	ADJ
мертвенно 	ADV
мертвецки 	ADV
мерчандайзер	NOUN
мерчандайзинг	NOUN
мессбауэровский	ADJ
мессер	NOUN
местночтимый	ADJ
местообитание	NOUN
месхетинец	NOUN
месье	NOUN
метагалактический	ADJ
метаданные	ADV
металлизовать	VERB
металлик	ADJ
металлически 	ADV
металлодетектор	NOUN
металлоискатель	NOUN
металлоорганический	ADJ
металлоорганосилоксан	NOUN
металлопродукция	NOUN
металлопрокат	NOUN
металлоремонт	NOUN
металлосилоксан	NOUN
металлоценовой	ADJ
метановоздушный	ADJ
метановый	ADJ
метасистема	NOUN
метастабильный	ADJ
метафорически 	ADV
метильный	ADJ
метионин	NOUN
метко 	ADV
меткомбинат	NOUN
методически 	ADV
методично 	ADV
методный	ADJ
методологически 	ADV
метчайший	ADJ
механически 	ADV
механоактивированный	ADJ
мечтанье	NOUN
мечтательно 	ADV
мечтаться	VERB
мешковато 	ADV
миасский	ADJ
мигун	NOUN
мидовский	ADJ
микояновский	ADJ
микроволновка	NOUN
микрогруппа	NOUN
микрозаписка	NOUN
микрокосмос	NOUN
микропора	NOUN
микросекунда	NOUN
микротвердость	NOUN
микротрещина	NOUN
микроуровень	NOUN
микрочип	NOUN
миксбордер	NOUN
микстинфекция	NOUN
миллениум	NOUN
миллионник	NOUN
миллисекунда	NOUN
мило 	ADV
милосерднейший	ADJ
милосердно 	ADV
милостиво 	ADV
мимолетно 	ADV
мингрел	NOUN
минерагенический	ADJ
минерализовать	VERB
минет	NOUN
миниатюризация	NOUN
минивэн	NOUN
минимально 	ADV
минимущество	NOUN
минкульт	NOUN
минобороновский	ADJ
миноритарий	NOUN
миноритарный	ADJ
минфиновский	ADJ
мирнейший	ADJ
мирно 	ADV
мирозданье	NOUN
миролюбивейший	ADJ
миролюбиво 	ADV
мироновский	ADJ
миротворчество	NOUN
мироточение	NOUN
мисочка	NOUN
мистериальный	ADJ
мистически 	ADV
митек	NOUN
митинский	ADJ
митоген	NOUN
митохондриальный	ADJ
митьковский	ADJ
миусский	ADJ
мифологизация	NOUN
мифологист	NOUN
михайловский	ADJ
михалковский	ADJ
мицубиси	NOUN
мишутка	NOUN
младенчески 	ADV
младореформатор	NOUN
младшенький	ADJ
мнемический	ADJ
мнестический	ADJ
мнимо 	ADV
многоагентный	ADJ
многоаспектный	ADJ
многовариантность	NOUN
многовекторный	ADJ
многоголосье	NOUN
многозарядный	ADJ
многозначнейший	ADJ
многокомнатный	ADJ
многокомпонентный	ADJ
многоконфессиональный	ADJ
многократно 	ADV
многокритериальный	ADJ
многолесной	ADJ
многоликость	NOUN
многомерность	NOUN
многомиллиардный	ADJ
многомудрый	ADJ
многообещающе 	ADV
многообразнейший	ADJ
многопартийность	NOUN
многопользовательский	ADJ
многополярность	NOUN
многопроцессорный	ADJ
многорядный	ADJ
многословно 	ADV
многослойность	NOUN
многостраничный	ADJ
многоуровневый	ADJ
многофакторный	ADJ
многофигурный	ADJ
многофункциональность	NOUN
многоходовый	ADJ
многоцветье	NOUN
многоцелевой	ADJ
многочисленнейший	ADJ
многочлениковый	ADJ
многоэтажка	NOUN
многоэтапный	ADJ
мобила	NOUN
мобилизовывать	VERB
мобильник	NOUN
мова	NOUN
могуче 	ADV
могущественнейший	ADJ
моделирующий	ADJ
моделька	NOUN
модернизационный	ADJ
модифицирование	NOUN
модно 	ADV
модульность	NOUN
мозаичность	NOUN
моздокский	ADJ
мокруха	NOUN
молдинг	NOUN
молекулярно 	ADV
молитвенно 	ADV
молитвословие	NOUN
молниеносно 	ADV
молодежка	NOUN
молодецки 	ADV
молодо 	ADV
молодцевато 	ADV
молокоотсос	NOUN
молотовский	ADJ
молчаливо 	ADV
молчанье	NOUN
мольеровский	ADJ
моментально 	ADV
монакский	ADJ
монд	NOUN
монетизация	NOUN
мониторинговый	ADJ
моновакцина	NOUN
моноклональный	ADJ
монокристаллический	ADJ
монолитно 	ADV
мономер	NOUN
мономерный	ADJ
мононациональный	ADJ
мононуклеарный	ADJ
монополь	NOUN
монопольно 	ADV
монослой	NOUN
монослойный	ADJ
монотонно 	ADV
моноцентрический	ADJ
монументально 	ADV
морально 	ADV
морвокзал	NOUN
морозовский	ADJ
морпех	NOUN
морфологически 	ADV
морфометрический	ADJ
моршанский	ADJ
мосальский	ADJ
мосфильмовский	ADJ
мотивационный	ADJ
мотоблок	NOUN
моторесурс	NOUN
моторхоум	NOUN
мотострелок	NOUN
моточас	NOUN
моцарелла	NOUN
моцартовский	ADJ
мощно 	ADV
мрачно 	ADV
мрачновато 	ADV
мстительно 	ADV
мудро 	ADV
мужественно 	ADV
мужчинка	NOUN
музейщик	NOUN
музицирование	NOUN
музкомедия	NOUN
музон	NOUN
музрук	NOUN
музучилище	NOUN
музыкально 	ADV
мукозальный	ADJ
мукозоадгезивный	ADJ
мультикультурализм	NOUN
мультикультурный	ADJ
мультимодальный	ADJ
мультипликативный	ADJ
мультсериал	NOUN
мульчирование	NOUN
мундирчик	NOUN
муровец	NOUN
мусик	NOUN
муслим	NOUN
мусорка	NOUN
мутагенез	NOUN
мутно 	ADV
мучающий	ADJ
мученически 	ADV
мученье	NOUN
мхатовец	NOUN
мхатовский	ADJ
мысленно 	ADV
мыслимо 	ADV
мычанье	NOUN
мьянманец	NOUN
мэм	NOUN
мягко 	ADV
мягколиственный	ADJ
мясницкий	ADJ
мясокостный	ADJ
мясоперерабатывающий	ADJ
наблюденье	NOUN
набоковский	ADJ
набоковский	ADJ
набоковский	ADJ
набрякать	VERB
наворачиваться	VERB
наворот	NOUN
навроде 	ADP
навязчиво 	ADV
навязывание	NOUN
нагатинский	ADJ
нагло 	ADV
нагловато 	ADV
наглядно 	ADV
нагружение	NOUN
надавливание	NOUN
надвратный	ADJ
надгробье	NOUN
надежно 	ADV
надменно 	ADV
надмирный	ADJ
надрывно 	ADV
надсадно 	ADV
надсолевой	ADJ
надтепловой	ADJ
надыбать	VERB
назаровский	ADJ
названье	NOUN
назидательно 	ADV
назойливо 	ADV
наиважнейший	ADJ
наивно 	ADV
наивыгоднейший	ADJ
наиглавнейший	ADJ
наигранно 	ADV
наипервейший	ADJ
наймодатель	NOUN
наказанье	NOUN
накапливание	NOUN
наклеивание	NOUN
наклонно 	ADV
нал	NOUN
налогооблагаемый	ADJ
налогооблагаемый	ADJ
наложиться	VERB
налысо 	ADV
наманикюренный	ADJ
намеренно 	ADV
наноалмаз	NOUN
нанокластер	NOUN
нанокристалл	NOUN
нанокристаллический	ADJ
наноразмерный	ADJ
наносистема	NOUN
наноструктура	NOUN
нанотехнология	NOUN
нанотрубка	NOUN
наночастица	NOUN
напевно 	ADV
напечатание	NOUN
наполненность	NOUN
напористо 	ADV
направленно 	ADV
напридумать	VERB
напридумывать	VERB
напряг	NOUN
напряг	NOUN
напряженка	NOUN
напряженнейший	ADJ
напряженно 	ADV
напрямки 	ADV
напыление	NOUN
напыщенно 	ADV
наработка	NOUN
наработки	NOUN
наработок	NOUN
нарастающий	ADJ
нардеп	NOUN
нарезание	NOUN
нарик	NOUN
наркобарон	NOUN
наркоделец	NOUN
наркодилер	NOUN
наркомзем	NOUN
наркоминдел	NOUN
наркоминдел	NOUN
наркомпрос	NOUN
наркомтяжпром	NOUN
наркомфин	NOUN
наркота	NOUN
наркоторговец	NOUN
наркоторговля	NOUN
наркотрафик	NOUN
наркоугроза	NOUN
нарочито 	ADV
наружка	NOUN
наружно 	ADV
нарциссизм	NOUN
нарядно 	ADV
насельница	NOUN
насильственно 	ADV
наслажденье	NOUN
наследодатель	NOUN
наследственно 	ADV
наследуемость	NOUN
насмешливо 	ADV
настойчиво 	ADV
настороженно 	ADV
настоятельно 	ADV
настырно 	ADV
насупленно 	ADV
насущно 	ADV
насыщенно 	ADV
нативный	ADJ
натужно 	ADV
натянуто 	ADV
наукоград	NOUN
наурыз	NOUN
научение	NOUN
научно 	ADV
нафиг 	ADV
нафиг 	PRED
нафига	ADV
нафига 	PRED
нахально 	ADV
нахалюга	NOUN
находкинский	ADJ
находчиво 	ADV
нацбанк	NOUN
нацбол	NOUN
националистически 	ADV
начальничек	NOUN
начальственно 	ADV
начкон	NOUN
начлаг	NOUN
начмед	NOUN
начхоз	NOUN
нашлемный	ADJ
нащокинский	ADJ
неагрессивный	ADJ
неадаптированный	ADJ
неадекватно 	ADV
неадекватность	NOUN
неаккуратно 	ADV
неактивный	ADJ
небанальный	ADJ
небанковский	ADJ
небедный	ADJ
небезопасно 	ADV
небезуспешно 	ADV
небезынтересно 	ADV
небескорыстно 	ADV
неблагополучно 	ADV
неблагоприятно 	ADV
небогато 	ADV
небрежно 	ADV
небритость	NOUN
небыстрый	ADJ
неведомо 	ADV
невежливо 	ADV
невербальный	ADJ
неверно 	ADV
невероятно 	ADV
невесело 	ADV
невесомо 	ADV
невиданно 	ADV
невидимо 	ADV
невидимость	NOUN
невидяще 	ADV
невинно 	ADV
невнимательно 	ADV
невнятно 	ADV
невоенный	ADJ
невозврат	NOUN
невозвратимо 	ADV
невозможное	NOUN
невообразимо 	ADV
невостребованность	NOUN
невостребованный	ADJ
невстреча	NOUN
невыгодно 	ADV
невыгодно 	PRED
невыдуманный	ADJ
невыносимо 	ADV
невыполненный	ADJ
невыпуклый	ADJ
невыраженный	ADJ
невыразимо 	ADV
невыразительно 	ADV
невысказанный	ADJ
невыспавшийся	ADJ
невыясненный	ADJ
негативно 	ADV
негласно 	ADV
негодующе 	ADV
негорючий	ADJ
негосударственный	ADJ
неготовность	NOUN
неготовый	ADJ
негражданин	NOUN
негромко 	ADV
негуманно 	ADV
негуманный	ADJ
негусто 	ADV
недвижимо 	ADV
недвижно 	ADV
недвусмысленно 	ADV
недействующий	ADJ
недемократический	ADJ
недемократичный	ADJ
неденежный	ADJ
неденоминированный	ADJ
недетский	ADJ
недешево 	ADV
недешевый	ADJ
недискриминационный	ADJ
недлинный	ADJ
недобро 	ADV
недобровольный	ADJ
недоброжелательно 	ADV
недобросовестно 	ADV
недоверчиво 	ADV
недовольно 	ADV
недоказанный	ADJ
недокуренный	ADJ
недолжный	ADJ
недоношенный	ADJ
недорезанный	ADJ
недорого 	ADV
недостижение	NOUN
недостойно 	ADV
недостроенный	ADJ
недоумевающе 	ADV
недоуменно 	ADV
недоучиваться	VERB
недоучившийся	ADJ
недофинансирование	NOUN
недофинансировать	VERB
недревесный	ADJ
недропользование	NOUN
недропользователь	NOUN
недружелюбно 	ADV
недурно 	ADV
недурно 	PRED
нееврей	NOUN
нееврейский	ADJ
неевропейский	ADJ
неестественно 	ADV
нежелательно 	ADV
неженский	ADJ
нежно 	ADV
независимо 	ADV
незагорелый	ADJ
незаинтересованный	ADJ
незаконно 	ADV
незакрытый	ADJ
незаметно 	ADV
незамеченный	ADJ
незамысловато 	ADV
незападный	ADJ
незапланированный	ADJ
незаполненный	ADJ
незарегистрированный	ADJ
незаслуженно 	ADV
незатейливо 	ADV
незачетный	ADJ
незащищенность	NOUN
незащищенный	ADJ
незнакомо 	ADV
незнаменитый	ADJ
незначительно 	ADV
незнающий	ADJ
незримо 	ADV
незыблемо 	ADV
неигровой	ADJ
неизбалованный	ADJ
неизбежно 	PRED
неизменно 	ADV
неизмеримо 	ADV
неимоверно 	ADV
неимущественный	ADJ
неинфицированный	ADJ
неискаженный	ADJ
неисключительный	ADJ
неискренне 	ADV
неиспользование	NOUN
неиспользованный	ADJ
неистово 	ADV
неистощительный	ADJ
нейраминидаза	NOUN
нейровирулентность	NOUN
нейронаука	NOUN
нейронный	ADJ
нейропсихологический	ADJ
нейросетевой	ADJ
нейросеть	NOUN
нейротрансмиттер	NOUN
нейрофизиолог	NOUN
нейтрализатор	NOUN
нейтраль	NOUN
нейтрально 	ADV
нейтрофил	NOUN
некачественно 	ADV
неклассический	ADJ
некодирующий	ADJ
неколебимо 	ADV
некоммерческий	ADJ
некомфортно 	ADV
некомфортно 	PRED
неконкурентный	ADJ
неконкурентоспособный	ADJ
неконструктивный	ADJ
неконфликтный	ADJ
некоренной	ADJ
некорректно 	ADV
некрасиво 	ADV
некрасовский	ADJ
некромаг	NOUN
неладное	NOUN
неласково 	ADV
нелегально 	ADV
нелегитимный	ADJ
нелепо 	ADV
нелесной	ADJ
нелетальный	ADJ
нелинейность	NOUN
нелицензионный	ADJ
нелицеприятно 	ADV
нелогично 	ADV
нелокальный	ADJ
нелояльный	ADJ
немагнитный	ADJ
немаркированный	ADJ
немедленно 	ADV
немилосердно 	ADV
неминуемо 	ADV
немонотонный	ADJ
немосковский	ADJ
немочка	NOUN
немчин	NOUN
немыслимо 	ADV
ненавистно 	ADV
ненавистно 	PRED
ненавязчиво 	ADV
ненадежно 	ADV
неназванный	ADJ
неназойливо 	ADV
неналоговый	ADJ
ненамеренный	ADJ
ненасилие	NOUN
ненасытно 	ADV
ненасыщенный	ADJ
ненатурально 	ADV
неновый	ADJ
ненормально 	ADV
ненормативный	ADJ
ненормированный	ADJ
ненулевой	ADJ
необдуманно 	ADV
необеспечение	NOUN
необидно 	ADV
необидный	ADJ
необоснованно 	ADV
необратимо 	ADV
необстрелянный	ADJ
необходимейший	ADJ
необщий	ADJ
необъявленный	ADJ
необъяснимо 	ADV
необъятное	NOUN
необыкновенно 	ADV
необычайно 	ADV
необычно 	ADV
необязательно 	ADV
неограниченно 	ADV
неодинаково 	ADV
неоднозначно 	ADV
неоднократно 	ADV
неодобрительно 	ADV
неодолимо 	ADV
неожиданно 	ADV
неоконченный	ADJ
неолиберализм	NOUN
неолиберальный	ADJ
неописуемо 	ADV
неоплата	NOUN
неоплаченный	ADJ
неопознанный	ADJ
неоправданно 	ADV
неопределенно 	ADV
неопровержимо 	ADV
неопрятно 	ADV
неопубликованный	ADJ
неорганизованно 	ADV
неорганичный	ADJ
неординарность	NOUN
неоригинальный	ADJ
неортодоксальный	ADJ
неосведомленный	ADJ
неосмотрительно 	ADV
неосмысленный	ADJ
неосновательно 	ADV
неосознанно 	ADV
неоспоримо 	ADV
неостановимый	ADJ
неосторожно 	ADV
неостроумный	ADJ
неотвратимо 	ADV
неотвязно 	ADV
неоткрытый	ADJ
неотлучно 	ADV
неотменимый	ADJ
неотразимо 	ADV
неотрывно 	ADV
неотступно 	ADV
неофициально 	ADV
неохраняемый	ADJ
неочевидный	ADJ
непараметрический	ADJ
непатриотичный	ADJ
непередаваемо 	ADV
непереносимо 	ADV
непересекающийся	ADJ
неплановый	ADJ
неплотно 	ADV
непобежденный	ADJ
неповрежденный	ADJ
неповторимо 	ADV
неподвижно 	ADV
неподготовленный	ADJ
неподдельно 	ADV
неподконтрольный	ADJ
неподписанный	ADJ
неподтвержденный	ADJ
неподцензурный	ADJ
неподъемный	ADJ
непозволительно 	ADV
непознанный	ADJ
непоказной	ADJ
непоколебимо 	ADV
неполезный	ADJ
неполитический	ADJ
неполиткорректный	ADJ
неположенный	ADJ
неполучение	NOUN
непомерно 	ADV
непонимающе 	ADV
непонятки	NOUN
непоправимо 	ADV
непопулярность	NOUN
непорядочно 	ADV
непосредственно 	ADV
непостижимо 	ADV
непостижимость	NOUN
непочтительно 	ADV
неправдоподобно 	ADV
неправедно 	ADV
неправильно 	ADV
неправомерно 	ADV
неправославный	ADJ
непредвзято 	ADV
непредвзятость	NOUN
непредвзятый	ADJ
непредвиденное	NOUN
непредельный	ADJ
непреднамеренно 	ADV
непредоставление	NOUN
непредставимый	ADJ
непредставление	NOUN
непредусмотренный	ADJ
непреклонно 	ADV
непрекращающийся	ADJ
непреодолимо 	ADV
непрерывно 	ADV
неприбыльный	ADJ
неприветливо 	ADV
непривычно 	ADV
непризнание	NOUN
неприкрыто 	ADV
неприлично 	ADV
неприменение	NOUN
неприметно 	ADV
непримиримо 	ADV
непринужденно 	ADV
непринципиальный	ADJ
неприсоединение	NOUN
непристойно 	ADV
непричесанный	ADJ
неприютный	ADJ
неприязненно 	ADV
непроверенный	ADJ
непроданный	ADJ
непродовольственный	ADJ
непрозрачность	NOUN
непроизводственный	ADJ
непроизвольно 	ADV
непроницаемо 	ADV
непропорционально 	ADV
непростительно 	ADV
непросто 	ADV
непространственный	ADJ
непрофессионализм	NOUN
непрофессиональный	ADJ
непрофильный	ADJ
непроходимо 	ADV
непроцентный	ADJ
непыльный	ADJ
неработающий	ADJ
неравновесный	ADJ
неравномерно 	ADV
нерадостный	ADJ
неразбавленный	ADJ
неразборчиво 	ADV
неразделенный	ADJ
нераздельно 	ADV
неразлучно 	ADV
неразрешенный	ADJ
неразрушающий	ADJ
неразрывно 	ADV
неразумно 	ADV
нерастраченный	ADJ
нерасчетливо 	ADV
нерафинированный	ADJ
нерационально 	ADV
нервически 	ADV
нервно 	ADV
нервозно 	ADV
нереализованный	ADJ
нереалистичный	ADJ
нереально 	ADV
нерегулируемый	ADJ
нерегулярно 	ADV
нерезаный	ADJ
нерезидент	NOUN
нерелигиозный	ADJ
нерешенность	NOUN
нерешенный	ADJ
нерешительно 	ADV
неровно 	ADV
нерчинский	ADJ
нерыночный	ADJ
неряшливо 	ADV
несанкционированный	ADJ
несбалансированность	NOUN
несбывшийся	ADJ
несвоевременно 	ADV
несвязанный	ADJ
несгибаемость	NOUN
несельскохозяйственный	ADJ
несертифицированный	ADJ
несерьезно 	ADV
несильно 	ADV
несильный	ADJ
несинонимичный	ADJ
несказанно 	ADV
нескладно 	ADV
нескончаемо 	ADV
нескоро 	ADV
нескромно 	ADV
нескучный	ADJ
неслабый	ADJ
несладкий	ADJ
несладко 	ADV
неслиянный	ADJ
несложно 	ADV
несложно 	PRED
неслучайно 	ADV
неслучайность	NOUN
неслучайный	ADJ
неслыханно 	ADV
неслышно 	ADV
несмело 	ADV
несмертельный	ADJ
несмешной	ADJ
несобранный	ADJ
несовершенно 	ADV
несоветский	ADJ
несознательно 	ADV
несоизмеримо 	ADV
несолидно 	ADV
несолидный	ADJ
несоответствующий	ADJ
несопоставимо 	ADV
несостоявшийся	ADJ
неспецифический	ADJ
неспешно 	ADV
неспешность	NOUN
несплошной	ADJ
неспокойно 	ADV
несправедиво 	ADV
несравнимо 	ADV
нестабильно 	ADV
нестабильный	ADJ
нестандартно 	ADV
нестационарный	ADJ
нестеровский	ADJ
нестратегический	ADJ
нестрашно 	ADV
нестрашно 	PRED
нестройно 	ADV
неструганый	ADJ
неструктурный	ADJ
нестыдный	ADJ
нестыковка	NOUN
нестяжательство	NOUN
несудебный	ADJ
несуетливый	ADJ
несуетный	ADJ
несуразно 	ADV
несущая	NOUN
несуществование	NOUN
несуществующий	ADJ
несчастие	NOUN
несъемный	ADJ
несырьевой	ADJ
нетаковец	NOUN
нетактично 	ADV
неталантливый	ADJ
нетвердо 	ADV
нетворческий	ADJ
нетерпеливо 	ADV
нетерпенье	NOUN
нетипичный	ADJ
нетоксичный	ADJ
нетолстый	ADJ
неторопливо 	ADV
неточно 	ADV
нетрадиционный	ADJ
нетранспортабельный	ADJ
нетренированный	ADJ
нетривиальный	ADJ
нетрудно 	ADV
нетрудно 	PRED
нетяжелый	ADJ
неубедительно 	ADV
неубитый	ADJ
неубранный	ADJ
неуважительно 	ADV
неуверенно 	ADV
неувязочка	NOUN
неудавшийся	ADJ
неудачно 	ADV
неудержимо 	ADV
неудивительно 	ADV
неудовлетворение	NOUN
неузнаваемо 	ADV
неуклонно 	ADV
неукоснительно 	ADV
неуловимо 	ADV
неумело 	ADV
неумеренно 	ADV
неуместно 	ADV
неумирающий	ADJ
неумно 	ADV
неумолимо 	ADV
неумолчно 	ADV
неуправляемость	NOUN
неурегулированность	NOUN
неустанно 	ADV
неустойчиво 	ADV
неутомимо 	ADV
неухоженный	ADJ
неучтенный	ADJ
неуют	NOUN
неуютность	NOUN
нефинансовый	ADJ
неформально 	ADV
нефрон	NOUN
нефтегаз	NOUN
нефтегазовый	ADJ
нефтегазодобывающий	ADJ
нефтегазоносность	NOUN
нефтегазоносный	ADJ
нефтегазопоисковый	ADJ
нефтегенерационный	ADJ
нефтекомпания	NOUN
нефтекомплекс	NOUN
нефтематеринский	ADJ
нефтеотдача	NOUN
нефтепродуктопровод	NOUN
нехай 	PART
нехарактерный	ADJ
нехилый	ADJ
нехристианский	ADJ
нехудожественный	ADJ
нецелевой	ADJ
нецелесообразно 	ADV
нецензурно 	ADV
неценовой	ADJ
нецивилизованный	ADJ
нечасто 	ADV
нечаянно 	ADV
нечеловек	NOUN
нечеловечески 	ADV
нечестно 	ADV
нечетко 	ADV
нечисто 	ADV
нешумный	ADJ
нещадно 	ADV
неэкономный	ADJ
неэндемичный	ADJ
неэстетично 	ADV
неэстетичный	ADJ
неэтилированный	ADJ
неэтичный	ADJ
неэффективно 	ADV
неэффективность	NOUN
неявно 	ADV
неядерный	ADJ
неярко 	ADV
неясно 	ADV
неясно 	PRED
ниагарский	ADJ
нижележащий	ADJ
нижневартовский	ADJ
нижнетагильский	ADJ
нижнечелюстной	ADJ
низинка	NOUN
низколетящий	ADJ
низкомолекулярный	ADJ
низкопрофильный	ADJ
низкоэнергетический	ADJ
низчайший	ADJ
ник	NOUN
никавир	NOUN
никитинский	ADJ
никитский	ADJ
николаевский	ADJ
никоновский	ADJ
никса	NOUN
ниндзя	NOUN
ниссан	NOUN
нитробензальдегид	NOUN
нитроцеллюлозный	ADJ
нифига	ADV
нифига 	PRED
ницшевский	ADJ
ницшевский	ADJ
ничегошеньки 	ADV
ничегошеньки 	PRED
ничейка	NOUN
ничтожно 	ADV
ништяк	NOUN
нобелевка	NOUN
нова	NOUN
ново 	ADV
новоарбатский	ADJ
новодел	NOUN
новокузнецкий	ADJ
новокуйбышевский	ADJ
новокурданский	ADJ
новомученик	NOUN
новообретенный	ADJ
новоросс	NOUN
новорусский	ADJ
новостной	ADJ
новочеркасский	ADJ
номенклатурщик	NOUN
номинально 	ADV
номинант	NOUN
номинировать	VERB
нон-стоп	ADV
нон-стоп	NOUN
нон-стоп	NOUN
ноне 	ADV
нонешний	ADJ
нонче	ADV
ноосферный	ADJ
норвег	NOUN
нордический	ADJ
норильчанин	NOUN
нормалек 	PRED
нормоконтроль	NOUN
нормотворческий	ADJ
нормотворчество	NOUN
норочка	NOUN
нортон	NOUN
носовский	ADJ
носогубной	ADJ
ностальгировать	VERB
ностальгически 	ADV
нотариально 	ADV
нравоучительно 	ADV
нравственно 	ADV
нужность	NOUN
нуклеация	NOUN
нуклеокапсид	NOUN
нуклеокапсид	NOUN
нуклеокапсидный	ADJ
нуклеопротеин	NOUN
нуклеосома	NOUN
нуклеотид	NOUN
нуклеотидный	ADJ
нунчак	NOUN
ньюсмейкер	NOUN
ньютоновский	ADJ
обалдело 	ADV
обалденный	ADJ
обанкротить	VERB
обаятельнейший	ADJ
обаятельно 	ADV
обвисший	ADJ
обводненность	NOUN
обворожительнейший	ADJ
обдуманно 	ADV
обездоленность	NOUN
обер	NOUN
обергруппенфюрер	NOUN
обертывание	NOUN
оберштурмбанфюрер	NOUN
обескураженно 	ADV
обеспокоенно 	ADV
обеспокоенный	ADJ
обессиленно 	ADV
обещанное	NOUN
обжатие	NOUN
обжигающе 	ADV
обидчиво 	ADV
обиженно 	ADV
обильнейший	ADJ
обильно 	ADV
обладминистрация	NOUN
облдума	NOUN
облегченно 	ADV
облизбирком	NOUN
обличие	NOUN
облкомстат	NOUN
обманчиво 	ADV
обменка	NOUN
обналичивание	NOUN
обнинский	ADJ
обноновец	NOUN
обобщенно 	ADV
обобщенность	NOUN
ободряюще 	ADV
обожение	NOUN
оболочечный	ADJ
обольстительнейший	ADJ
оборонка	NOUN
оборонщик	NOUN
обоснованно 	ADV
обособленно 	ADV
обостренно 	ADV
обоюдно 	ADV
обрадованно 	ADV
образно 	ADV
образованнейший	ADJ
образованье	NOUN
образцовейший	ADJ
образцово 	ADV
обратное	NOUN
обращенный	NOUN
обреченно 	ADV
обрывчик	NOUN
обстановочка	NOUN
обстоятельно 	ADV
обустраиваться	VERB
обустроиться	VERB
обуховский	ADJ
обученность	NOUN
обходительнейший	ADJ
общак	NOUN
общевоинский	ADJ
общежитский	ADJ
общекультурный	ADJ
общенаучный	ADJ
общепланетарный	ADJ
общеправовой	ADJ
общепсихологический	ADJ
общесистемный	ADJ
обществознание	NOUN
общестроительный	ADJ
общефедеральный	ADJ
общецерковный	ADJ
общеэкономический	ADJ
общинность	NOUN
общительнейший	ADJ
объединенность	NOUN
объединенный	ADJ
объективно 	ADV
объектно 	ADV
объемно 	ADV
объятье	NOUN
обыгрывание	NOUN
обыденно 	ADV
обыкновеннейший	ADJ
обычнейший	ADJ
обязательнейший	ADJ
овально 	ADV
овертайм	NOUN
огибание	NOUN
огибающая	NOUN
оглоед	NOUN
оглушение	NOUN
оглушительно 	ADV
огненно 	ADV
огнеупоры	NOUN
огорченно 	ADV
ограниченно 	ADV
огульно 	ADV
одареннейший	ADJ
одинар	NOUN
одинец	NOUN
одиноко 	ADV
одиночница	NOUN
одинцовский	ADJ
одиознейший	ADJ
однобоко 	ADV
одногруппник	NOUN
однозначно 	ADV
однократно 	ADV
одномандатник	NOUN
одномоментно 	ADV
однонаправленный	ADJ
однообразно 	ADV
односложно 	ADV
односторонне 	ADV
однотонно 	ADV
одноцепочечный	ADJ
одноэлектронный	ADJ
однушка	NOUN
одобрительно 	ADV
одурительный	ADJ
одуряюще 	ADV
одышливо 	ADV
одышливый	ADJ
ожесточеннейший	ADJ
ожесточенно 	ADV
оживленнейший	ADJ
оживленно 	ADV
ожиданье	NOUN
озабоченно 	ADV
озадаченно 	ADV
озвучание	NOUN
оздоравливать	VERB
озлобленно 	ADV
озонид	NOUN
озорно 	ADV
озябший	ADJ
окаменевший	ADJ
окаяннейший	ADJ
окинавский	ADJ
околоводный	ADJ
окончательно 	ADV
окончательность	NOUN
окормление	NOUN
окормлять	VERB
окоченение	NOUN
окрепший	ADJ
окровавленный	ADJ
округло 	ADV
окруженец	NOUN
оксидный	ADJ
октантный	ADJ
олефин	NOUN
олигомер	NOUN
олигомеризация	NOUN
олигомерный	ADJ
олигонуклеотид	NOUN
олигонуклеотидный	ADJ
ольховский	ADJ
омбудсмен	NOUN
омерзительнейший	ADJ
омерзительно 	ADV
омон	NOUN
омыватель	NOUN
онлайн	NOUN
онлайновый	ADJ
оное	NOUN
опасливо 	ADV
опер	NOUN
операнд	NOUN
оперативно 	ADV
операциональный	ADJ
оперенье	NOUN
оперуполномоченный	NOUN
опиат	NOUN
оплакивание	NOUN
опознаватель	NOUN
ополаскиватель	NOUN
опорожнение	NOUN
опосредование	NOUN
опосредованно 	ADV
опосредованность	NOUN
опосредствование	NOUN
оппозиционно 	ADV
определенно 	ADV
определенье	NOUN
опрометчиво 	ADV
опросник	NOUN
опротестование	NOUN
опрошенный	NOUN
опрятно 	ADV
оптимальнейший	ADJ
оптимально 	ADV
оптимизационный	ADJ
оптимистически 	ADV
оптимистично 	ADV
оптинский	ADJ
оптически 	ADV
оптоволоконный	ADJ
оптоэлектронный	ADJ
опухший	ADJ
опушение	NOUN
оранж	NOUN
орбиталь	NOUN
органайзер	NOUN
органелла	NOUN
организационно 	ADV
организованнейший	ADJ
организованно 	ADV
органически 	ADV
органичнейший	ADJ
органично 	ADV
оргвопрос	NOUN
оргвывод	NOUN
оргинструкторский	ADJ
оргпреступность	NOUN
оргструктура	NOUN
ордерный	ADJ
орджоникидзевский	ADJ
ореховский	ADJ
оригинальнейший	ADJ
оригинально 	ADV
ориентационный	ADJ
ориентированность	NOUN
ориентировочно 	ADV
ортодоксальнейший	ADJ
оруденение	NOUN
оруэлловский	ADJ
оршанский	ADJ
осведомленнейший	ADJ
освежитель	NOUN
осветление	NOUN
оскаровский	ADJ
оскорбительно 	ADV
оскорбленно 	ADV
ослабший	ADJ
ослепительно 	ADV
осмотрительно 	ADV
осмысленно 	ADV
основанье	NOUN
основательнейший	ADJ
основательно 	ADV
особливо 	ADV
особость	NOUN
осознавание	NOUN
осознанно 	ADV
оспаривание	NOUN
осповакцина	NOUN
осреднение	NOUN
оставленность	NOUN
остальные	NOUN
останкинский	ADJ
остеопат	NOUN
остервенело 	ADV
остолбенело 	ADV
осторожнейший	ADJ
осторожно 	ADV
остроумнейший	ADJ
остроумно 	ADV
острохарактерный	ADJ
осуждающе 	ADV
осязаемо 	ADV
отбрасывание	NOUN
отважнейший	ADJ
отважно 	ADV
отверждение	NOUN
отвержение	NOUN
отверточный	ADJ
отвесно 	ADV
ответно 	ADV
ответственнейший	ADJ
ответственно 	ADV
отвисший	ADJ
отвлеченнейший	ADJ
отвлеченно 	ADV
отвратительнейший	ADJ
отвратнейший	ADJ
отвыкший	ADJ
отвязнейший	ADJ
отвязный	ADJ
отгрузочный	ADJ
отдаленно 	ADV
отделенность	NOUN
отделенье	NOUN
отжимание	NOUN
отказополучатель	NOUN
откликаемость	NOUN
откомментировать	VERB
откровеннейший	ADJ
откровенно 	ADV
открывание	NOUN
открыто 	ADV
открыточка	NOUN
откудова 	ADVPRO
отладочный	ADJ
отличимый	ADJ
отмазаться	VERB
отмазка	NOUN
отменнейший	ADJ
отменно 	ADV
отметелить	VERB
отморозок	NOUN
отмывание	NOUN
относительнейший	ADJ
отношенье	NOUN
отопитель	NOUN
оторва	NOUN
отраднейший	ADJ
отраженье	NOUN
отрезвляюще 	ADV
отрешенно 	ADV
отрицательно 	ADV
отрывисто 	ADV
отрывочно 	ADV
отслеживание	NOUN
отснимать	VERB
отстойнейший	ADJ
отстоящий	ADJ
отстраненно 	ADV
отстраненность	NOUN
отсюдова 	ADVPRO
отточенность	NOUN
оттудова 	ADVPRO
отходняк	NOUN
отхождение	NOUN
отчаяннейший	ADJ
отчаянно 	ADV
отчаянье	NOUN
отчёт	NOUN
отчетливейший	ADJ
отчетливо 	ADV
отчужденно 	ADV
отшелушивать	VERB
отщепление	NOUN
отыскание	NOUN
оферта	NOUN
офигенный	ADJ
офигеть	VERB
офигительнейший	ADJ
офигительный	ADJ
офицерик	NOUN
официальнейший	ADJ
официально 	ADV
офтальмогерпес	NOUN
охотский	ADJ
охотхозяйство	NOUN
охранительнейший	ADJ
охранница	NOUN
охренеть	VERB
оценивание	NOUN
оценивающе 	ADV
оцепенело 	ADV
оцифровка	NOUN
оцифровывать	VERB
очаковский	ADJ
очарованье	NOUN
очаровательнейший	ADJ
очаровательно 	ADV
очаровашка	NOUN
очевиднейший	ADJ
очеловечивание	NOUN
очернение	NOUN
очечка	NOUN
очно 	ADV
очумело 	ADV
ошалело 	ADV
ошарашенно 	ADV
ошеломленно 	ADV
ошеломляюще 	ADV
ошибочно 	ADV
ощутимо 	ADV
павловский	ADJ
павловский	ADJ
павлодарский	ADJ
пагубно 	ADV
паддок	NOUN
паденье	NOUN
паджеро	NOUN
падла	NOUN
пазик	NOUN
пазл	NOUN
пакер	NOUN
палеарктический	ADJ
палисадничек	NOUN
пальцевый	ADJ
памятнейший	ADJ
панически 	ADV
панкисский	ADJ
панч	NOUN
папик	NOUN
папусик	NOUN
параглосса	NOUN
парадная	NOUN
парадно 	ADV
парадоксальнейший	ADJ
парадоксально 	ADV
параллельно 	ADV
параноидальный	ADJ
параплан	NOUN
парапрокт	NOUN
паратип	NOUN
парвовирус	NOUN
парвовирусный	ADJ
паркинг	NOUN
парковочный	ADJ
парктроник	NOUN
парктроник	NOUN
парогазовый	ADJ
пародийно 	ADV
пародонт	NOUN
паротитный	ADJ
партайгеноссе	NOUN
партаппарат	NOUN
партенокарпик	NOUN
парти	NOUN
партийнейший	ADJ
парткомиссия	NOUN
партнерство	NOUN
партноменклатура	NOUN
партсписок	NOUN
партстроительство	NOUN
партячейка	NOUN
парфюм	NOUN
паршивейший	ADJ
паршиво 	ADV
паскуднейший	ADJ
пассажирооборот	NOUN
пассеровать	VERB
пассивно 	ADV
пассионарий	NOUN
пассионарность	NOUN
пассионарный	ADJ
пассирование	NOUN
пастернаковский	ADJ
патентование	NOUN
патентообладатель	NOUN
патентоспособность	NOUN
патетически 	ADV
патовый	ADJ
патоген	NOUN
патогенность	NOUN
патологически 	ADV
патологоанатомический	ADJ
патоморфологический	ADJ
патопсихологический	ADJ
патриотически 	ADV
патриотично 	ADV
паттерн	NOUN
пахан	NOUN
пациенс	NOUN
пачечка	NOUN
пашийский	ADJ
певуче 	ADV
пегматоидный	ADJ
педагогически 	ADV
педантичнейший	ADJ
педантично 	ADV
педик	NOUN
пейнтбол	NOUN
пейнтбольный	ADJ
пелевинский	ADJ
пелотон	NOUN
пельменник	NOUN
пенопластовый	ADJ
пенополистирол	NOUN
пенополиуретан	NOUN
пентхауз	NOUN
пентхаус	NOUN
пепси	NOUN
пептидный	ADJ
первично 	ADV
первоверховный	ADJ
первоиерарх	NOUN
первоначально 	ADV
первоописание	NOUN
первосвятитель	NOUN
первосвятительский	ADJ
первосортнейший	ADJ
первостепеннейший	ADJ
первость	NOUN
пергола	NOUN
переброс	NOUN
перевидеть	VERB
перевозбуждать	VERB
перевозбуждение	NOUN
переворачивание	NOUN
переговорник	NOUN
передачка	NOUN
переделкинский	ADJ
передергивание	NOUN
переднебоковой	ADJ
переднегрудь	NOUN
переднеприводной	ADJ
переднеспинка	NOUN
перезагрузка	NOUN
перекрестие	NOUN
перекрестье	NOUN
перекрывание	NOUN
перемешивание	NOUN
перемирать	VERB
перемышльский	ADJ
перенаправлять	VERB
перенастройка	NOUN
переоснащение	NOUN
переоформление	NOUN
переподчинение	NOUN
переполненный	ADJ
перепрофилирование	NOUN
перерабатывающий	ADJ
переработчик	NOUN
перестойный	ADJ
перестрахование	NOUN
перестройщик	NOUN
пересыщение	NOUN
перетекание	NOUN
переток	NOUN
перетягивание	NOUN
переувлажнение	NOUN
переуступка	NOUN
переяславский	ADJ
перинатальный	ADJ
периодически 	ADV
перитонеальный	ADJ
перифразирование	NOUN
перманентно 	ADV
пероксид	NOUN
пероксидаза	NOUN
пероксидный	ADJ
перпендикулярно 	ADV
персептрон	NOUN
персистенция	NOUN
персонализация	NOUN
персонально 	ADV
перспективнейший	ADJ
перформанс	NOUN
перфторолефин	NOUN
перцептивный	ADJ
песковский	ADJ
пессимистически 	ADV
пессимистично 	ADV
пестивирус	NOUN
пестовский	ADJ
пестро 	ADV
петербурженка	NOUN
петергофский	ADJ
петрофизический	ADJ
петтинг	NOUN
петушинский	ADJ
печальнейший	ADJ
печатно 	ADV
печенгский	ADJ
печерский	ADJ
пиарить	VERB
пиаровский	ADJ
пиарщик	NOUN
пиелонефрит	NOUN
пикантнейший	ADJ
пикантно 	ADV
пикапчик	NOUN
пиквикский	ADJ
пикирование	NOUN
пиксель	NOUN
пилатес	NOUN
пилинг	NOUN
пилотский	ADJ
пин	NOUN
пинг	NOUN
пипл	NOUN
пирогенный	ADJ
пироговский	ADJ
пирологический	ADJ
пирсинг	NOUN
пискаревский	ADJ
письменно 	ADV
пит-стоп	NOUN
пиф	NOUN
плаванье	NOUN
плавающий	ADJ
плавно 	ADV
плавсредство	NOUN
плазмида	NOUN
плазмидный	ADJ
плазмон	NOUN
плакатик	NOUN
плаксиво 	ADV
пламенно 	ADV
планетка	NOUN
планово 	ADV
планомерно 	ADV
пластит	NOUN
пластически 	ADV
платежка	NOUN
платно 	ADV
платонически 	ADV
платоновский	ADJ
плачевно 	ADV
плевненский	ADJ
плей-офф	NOUN
плеймейкер	NOUN
пленочка	NOUN
пленочка	NOUN
плетистый	ADJ
плехановский	ADJ
плитный	ADJ
плиточник	NOUN
плодороднейший	ADJ
плодотворнейший	ADJ
плодотворно 	ADV
плоско 	ADV
плотнейший	ADJ
плотно 	ADV
плотностный	ADJ
плотоядно 	ADV
плоттер	NOUN
плоховато 	ADV
плохое	NOUN
плывущий	ADJ
плюс-минус 	ADV
пневмоподвеска	NOUN
по-азербайджански 	ADV
по-американски 	ADV
по-английски 	ADV
по-арабски 	ADV
по-арамейски 	ADV
по-армянски 	ADV
по-гречески 	ADV
по-грузински 	ADV
по-джентльменски 	ADV
по-еврейски 	ADV
по-европейски 	ADV
по-испански 	ADV
по-итальянски 	ADV
по-киевски 	ADV
по-китайски 	ADV
по-королевски 	ADV
по-крестьянски 	ADV
по-ленински 	ADV
по-литовски 	ADV
по-любому 	ADV
по-монгольски 	ADV
по-московски 	ADV
по-мужицки 	ADV
по-нашенски 	ADV
по-немецки 	ADV
по-норвежски 	ADV
по-польски 	ADV
по-приятельски 	ADV
по-российски 	ADV
по-русски 	ADV
по-славянски 	ADV
по-советски 	ADV
по-соседски 	ADV
по-татарски 	ADV
по-турецки 	ADV
по-украински 	ADV
по-фински 	ADV
по-французски 	ADV
по-христиански 	ADV
по-царски 	ADV
по-чеченски 	ADV
по-чешски 	ADV
по-шведски 	ADV
по-эстонски 	ADV
по-юношески 	ADV
по-японски 	ADV
побеговый	ADJ
победно 	ADV
победоносец	NOUN
победоносно 	ADV
повально 	ADV
повелительно 	ADV
поверхностно 	ADV
повествоваться	VERB
повислый	ADJ
повисший	ADJ
поворачиваемость	NOUN
поворотник	NOUN
повременка	NOUN
повседневно 	ADV
повсеместно 	ADV
повспоминать	VERB
повторенье	NOUN
повторно 	ADV
повторность	NOUN
поганейший	ADJ
погано 	ADV
погасший	ADJ
поглаживание	NOUN
поголовно 	ADV
погорелица	NOUN
погранец	NOUN
погранотряд	NOUN
погранслужба	NOUN
погруженность	NOUN
подавленно 	ADV
подакцизный	ADJ
податливо 	ADV
подбитый	ADJ
подбрюшье	NOUN
подворовывать	VERB
подвывание	NOUN
поддатый	ADJ
поддых 	ADV
подельщик	NOUN
подзадача	NOUN
подзадерживаться	VERB
подзаправляться	VERB
подзона	NOUN
подкапливаться	VERB
подклет	NOUN
подковерный	ADJ
подконтрольность	NOUN
подло 	ADV
подложка	NOUN
поднимание	NOUN
подножье	NOUN
подносик	NOUN
подобострастно 	ADV
подозрительно 	ADV
подотрасль	NOUN
подписант	NOUN
подпольно 	ADV
подпространство	NOUN
подпружинивать	VERB
подрагивание	NOUN
подредактировать	VERB
подрешетка	NOUN
подробно 	ADV
подследственность	NOUN
подслеповато 	ADV
подслизистый	ADJ
подсоединяться	VERB
подсознательно 	ADV
подсолевой	ADJ
подспудно 	ADV
подставляться	VERB
подствольный	ADJ
подструктура	NOUN
подталкивание	NOUN
подтопление	NOUN
подустать	VERB
подходяще 	ADV
подчеркнуто 	ADV
поедание	NOUN
поединщик	NOUN
пожаробезопасность	NOUN
пожаротушение	NOUN
пожароустойчивость	NOUN
пожизненно 	ADV
позакрывать	VERB
позволительно 	ADV
позвякивание	NOUN
позднесоветский	ADJ
позитивно 	ADV
позиционирование	NOUN
позиционировать	VERB
познанье	NOUN
позорно 	ADV
поизучать	VERB
поиронизировать	VERB
показательно 	ADV
покаянно 	ADV
поквартирный	ADJ
покемон	NOUN
покидание	NOUN
поклажедатель	NOUN
поковыряться	VERB
покойничек	NOUN
покойно 	ADV
поколенческий	ADJ
поколенье	NOUN
покорнейше 	ADV
покорно 	ADV
покровительственно 	ADV
полагание	NOUN
поленье	NOUN
полиакриламидный	ADJ
поливальный	ADJ
поливитамин	NOUN
поликарбонат	NOUN
поликлональный	ADJ
поликристаллический	ADJ
полимераза	NOUN
полимеразный	ADJ
полиметалл	NOUN
полиметаллоорганосилоксан	NOUN
полиномиальный	ADJ
полиовирус	NOUN
полипептидный	ADJ
полиплоид	NOUN
полипренол	NOUN
полироль	NOUN
полистироловый	ADJ
политех	NOUN
политзанятие	NOUN
политизировать	VERB
политически 	ADV
политологический	ADJ
политорган	NOUN
политсовет	NOUN
политтехнолог	NOUN
политтехнологический	ADJ
политтехнология	NOUN
политэлита	NOUN
полицентрический	ADJ
полиэдроз	NOUN
полиэтнический	ADJ
полиэфирный	ADJ
полкило	NOUN
поллютант	NOUN
полноприводной	ADJ
полноразмерный	ADJ
полнофункциональный	ADJ
полноцветный	ADJ
полноценно 	ADV
половозрастный	ADJ
полого 	ADV
положенье	NOUN
положительнейший	ADJ
положительно 	ADV
полосочка	NOUN
полотенцесушитель	NOUN
полуактивный	ADJ
полублатной	ADJ
полувопросительно 	ADV
полудохлый	ADJ
полузакрывать	VERB
полузнакомый	ADJ
полуистлевать	VERB
полукопченый	ADJ
полукриминальный	ADJ
полукружье	NOUN
полулунный	ADJ
полумифический	ADJ
полуобертываться	VERB
полуобнимать	VERB
полуоткрыть	VERB
полуподпольный	ADJ
полуприкрывать	VERB
полуприкрыть	VERB
полупрофессиональный	ADJ
полуразваливаться	VERB
полуразрушить	VERB
полурусский	ADJ
полусамоизмельчение	NOUN
полусгнивать	VERB
полусерьезно 	ADV
полускрытый	ADJ
полустертый	ADJ
полусферический	ADJ
полутемно 	ADV
полуторалитровый	ADJ
полушутливо 	ADV
пользовательский	ADJ
польский	ADJ
полюбовно 	ADV
полярно 	ADV
помеховый	ADJ
помехозащищенность	NOUN
помешивание	NOUN
поминутно 	ADV
помкомвзвода	NOUN
помоечный	ADJ
помпезно 	ADV
помреж	NOUN
помреж	NOUN
помывка	NOUN
помятейший	ADJ
понаписать	VERB
понатыкать	VERB
понижающий	ADJ
понимающе 	ADV
понтийский	ADJ
понты	NOUN
понуро 	ADV
понятливо 	ADV
понятнейший	ADJ
пообщаться	VERB
поотрывать	VERB
поочередно 	ADV
поощрительно 	ADV
попарный	ADJ
поперед 	ADP
попеременный	ADJ
поперечно 	ADV
поперечнополосатый	ADJ
попискивание	NOUN
попозировать	VERB
попочка	NOUN
поприсутствовать	VERB
попса	NOUN
популярнейший	ADJ
популярно 	ADV
популяционный	ADJ
пораженно 	ADV
пораженность	NOUN
поразительнейший	ADJ
поразительно 	ADV
порассуждать	VERB
порепетировать	VERB
порешать	VERB
порнозвезда	NOUN
порносайт	NOUN
порнуха	NOUN
порнушка	NOUN
поровый	ADJ
портфолио	NOUN
порубочный	ADJ
поруливать	VERB
порше	NOUN
порывисто 	ADV
порядочнейший	ADJ
посильно 	ADV
послевкусие	NOUN
послевузовский	ADJ
послегарантийный	ADJ
последование	NOUN
последовательно 	ADV
послекризисный	ADJ
послепожарный	ADJ
послепраздничный	ADJ
послепродажный	ADJ
послесталинский	ADJ
послойно 	ADV
послушнейший	ADJ
послушно 	ADV
посмертно 	ADV
пособирать	VERB
поспешно 	ADV
посредственнейший	ADJ
поствакцинальный	ADJ
постгенитальный	ADJ
постепенно 	ADV
посткоммунистический	ADJ
постконтузионный	ADJ
постконфликтный	ADJ
посткризисный	ADJ
постмодернистский	ADJ
постреволюционный	ADJ
постсоциалистический	ADJ
посттравматический	ADJ
постыднейший	ADJ
постыдно 	ADV
посходить	VERB
потаенно 	ADV
потаповский	ADJ
потенциально 	ADV
потерянно 	ADV
потешка	NOUN
потийский	ADJ
потоковый	ADJ
потостойкость	NOUN
потребительство	NOUN
потребностный	ADJ
потрясающе 	ADV
потрясенно 	ADV
потрясный	ADJ
потусоваться	VERB
поулыбаться	VERB
поучительнейший	ADJ
поучительно 	ADV
пофамильный	ADJ
пофиг 	PRED
пофигизм	NOUN
похабнейший	ADJ
похабно 	ADV
похвально 	ADV
похмельный	ADJ
похоже 	PARENTH
похудание	NOUN
похулиганить	VERB
поцелуйчик	NOUN
поцокать	VERB
почвогрунт	NOUN
почвопокровный	ADJ
почетнейший	ADJ
почетно 	ADV
почечка	NOUN
почтительно 	ADV
пошаговый	ADJ
пошататься	VERB
пошибать	VERB
пошло 	ADV
поштучно 	ADV
пошуровать	VERB
пошуршать	VERB
поэкспериментировать	VERB
поэтапно 	ADV
поэтически 	ADV
поэтичнейший	ADJ
поэтично 	ADV
правдивейший	ADJ
правдиво 	ADV
правдоподобно 	ADV
праведнейший	ADJ
праведно 	ADV
правильнейший	ADJ
правильно 	ADV
правовернейший	ADJ
правомерно 	ADV
правообладатель	NOUN
правоохранитель	NOUN
правоохранительный	ADJ
правопреемница	NOUN
правоприменение	NOUN
правоприменитель	NOUN
правоприменительный	ADJ
праворульный	ADJ
правосубъектность	NOUN
правотворческий	ADJ
правотворчество	NOUN
правоустанавливать	VERB
правоустанавливающий	ADJ
прагматически 	ADV
прагматичнейший	ADJ
прагматично 	ADV
празднично 	ADV
праздно 	ADV
прайд	NOUN
прайм-тайм	NOUN
праймер	NOUN
прайс	NOUN
прайс-лист	NOUN
практически 	ADV
практично 	ADV
праславянский	ADJ
превалирование	NOUN
превеликий	ADJ
превосходнейший	ADJ
превратно 	ADV
превращенье	NOUN
прегенитальный	ADJ
преданнейший	ADJ
преданно 	ADV
преданье	NOUN
предвзято 	ADV
предельно 	ADV
предельщик	NOUN
предметно 	ADV
преднамеренно 	ADV
предостаточно 	ADV
предостерегающе 	ADV
предположительно 	ADV
предпочтенье	NOUN
предпочтительно 	ADV
предпроектный	ADJ
предсерийный	ADJ
предсказанье	NOUN
предсказуемо 	ADV
представленность	NOUN
представленье	NOUN
предстательство	NOUN
предстояние	NOUN
предстоятель	NOUN
предсуществование	NOUN
предупредительно 	ADV
предупреждающий	ADJ
предусмотрительно 	ADV
преждевременно 	ADV
презабавнейший	ADJ
презентационный	ADJ
презренье	NOUN
презрительно 	ADV
прекурсор	NOUN
прелестно 	ADV
прелюбопытнейший	ADJ
прелюбопытный	ADJ
преморбидный	ADJ
премьер-лига	NOUN
пренатальный	ADJ
пренеприятнейший	ADJ
преогромнейший	ADJ
преп	NOUN
препод	NOUN
преподобномученица	NOUN
препроцессор	NOUN
прерывание	NOUN
прерывисто 	ADV
пресветлый	ADJ
пресекательный	ADJ
преславный	ADJ
пресмыкание	NOUN
пресно 	ADV
преспокойненько 	ADV
пресс-релиз	NOUN
престернум	NOUN
престижнейший	ADJ
престижно 	ADV
престижность	NOUN
престраннейший	ADJ
преступно 	ADV
претензионный	ADJ
претенциозно 	ADV
преувеличенно 	ADV
преуспевание	NOUN
прехорошенький	ADJ
прецедентный	ADJ
пречерный	ADJ
пречистенский	ADJ
прибабах	NOUN
прибамбас	NOUN
приблатненный	ADJ
прибыльнейший	ADJ
приватизатор	NOUN
приватно 	ADV
приветик	NOUN
приветливо 	ADV
приветственно 	ADV
привилегированнейший	ADJ
привлекательнейший	ADJ
привлекательно 	ADV
привольно 	ADV
приворовывать	VERB
привыкший	ADJ
привычно 	ADV
приглашающе 	ADV
приглушенно 	ADV
приготовленье	NOUN
пригреваться	VERB
придирчивейший	ADJ
придирчиво 	ADV
придумывание	NOUN
придурочный	ADJ
приемлемо 	ADV
приемосдатчик	NOUN
приемчик	NOUN
прижизненно 	ADV
прижмуривать	VERB
призабойный	ADJ
признаковый	ADJ
признанность	NOUN
призрачнейший	ADJ
призрачно 	ADV
призывно 	ADV
прикалываться	VERB
прикид	NOUN
прикнопить	VERB
приколоться	VERB
прикольно 	ADV
прикроватный	ADJ
прилежнейший	ADJ
прилежно 	ADV
приличнейший	ADJ
прилично 	ADV
прилукинский	ADJ
прилюдный	ADJ
примернейший	ADJ
примесный	ADJ
приметно 	ADV
примечательнейший	ADJ
примечательно 	ADV
примирительно 	ADV
примиряюще 	ADV
примитивнейший	ADJ
примитивно 	ADV
примкнутый	ADJ
принадлежащий	ADJ
принародно 	ADV
принсипский	ADJ
принстонский	ADJ
принудительно 	ADV
принужденно 	ADV
принципиальнейший	ADJ
принципиально 	ADV
принято 	PART
приобнимать	VERB
приобнять	VERB
приобщенность	NOUN
прион	NOUN
прионный	ADJ
приоритетнейший	ADJ
приоритетность	NOUN
приоткрытый	ADJ
приповерхностный	ADJ
припухший	ADJ
природно 	ADV
природопользование	NOUN
присасывание	NOUN
прискорбнейший	ADJ
приспособительный	ADJ
пристально 	ADV
пристенковский	ADJ
пристенок	NOUN
пристенок	NOUN
пристойно 	ADV
пристрастно 	ADV
притворно 	ADV
притопать	VERB
притопить	VERB
притоптывать	VERB
приторнейший	ADJ
приторно 	ADV
притундровый	ADJ
прихотливейший	ADJ
прихотливо 	ADV
прицельно 	ADV
причаливание	NOUN
причинитель	NOUN
причудливейший	ADJ
причудливо 	ADV
пришвинский	ADJ
приятельствовать	VERB
приятное	NOUN
пробивание	NOUN
проблематизация	NOUN
проблематично 	ADV
проблемка	NOUN
проблемно 	ADV
проблесковый	ADJ
пробоваться	VERB
пробочка	NOUN
провайдер	NOUN
проверяющий	NOUN
провидческий	ADJ
провинциально 	ADV
провирус	NOUN
провирусный	ADJ
провисший	ADJ
проводка	NOUN
проводочка	NOUN
проводящий	ADJ
провокативный	ADJ
проворно 	ADV
провоспалительный	ADJ
провоцирование	NOUN
проговорка	NOUN
прогревочный	ADJ
прогрессивнейший	ADJ
прогрессивно 	ADV
прогрессирование	NOUN
прогрессор	NOUN
продавливание	NOUN
продвинутость	NOUN
продекларировать	VERB
продирижировать	VERB
продуктивнейший	ADJ
продуктивно 	ADV
продукционный	ADJ
продуманно 	ADV
продумывание	NOUN
продуцирование	NOUN
продюсировать	VERB
проецирование	NOUN
прозаически 	ADV
прозаично 	ADV
прозорливо 	ADV
прозоровский	ADJ
прозрачнейший	ADJ
прозрачно 	ADV
проигнорировать	VERB
проигрывание	NOUN
производное	NOUN
произвольно 	ADV
проиндексировать	VERB
проинтерпретировать	VERB
проклятье	NOUN
прокоммунистический	ADJ
прокофьевский	ADJ
прокремлевский	ADJ
проксимальный	ADJ
прокурорша	NOUN
пролиферативный	ADJ
пролоббировать	VERB
промакадемия	NOUN
промедол	NOUN
промоутер	NOUN
промпартия	NOUN
промышленно 	ADV
пронаблюдать	VERB
пронзительно 	ADV
проникновеннейший	ADJ
проникновенно 	ADV
проницательнейший	ADJ
проницательно 	ADV
пропагандный	ADJ
пропласток	NOUN
проплата	NOUN
проплачивать	VERB
пропорционально 	ADV
проправительственный	ADJ
пропрезидентский	ADJ
пропускание	NOUN
пропутинский	ADJ
прорезиненный	ADJ
пророгационный	ADJ
пророссийский	ADJ
пророчески 	ADV
просвещеннейший	ADJ
просительно 	ADV
прослеживание	NOUN
прослушка	NOUN
прослушка	NOUN
проставление	NOUN
проставляться	VERB
простагландин	NOUN
простерилизовать	VERB
простимулировать	VERB
простирание	NOUN
простительно 	ADV
простодушно 	ADV
просторечье	NOUN
просторнейший	ADJ
просторно 	ADV
пространнейший	ADJ
пространно 	ADV
пространственно 	ADV
пространственность	NOUN
протаивание	NOUN
проталкивание	NOUN
протаскивание	NOUN
протеаза	NOUN
протеиназа	NOUN
протективный	ADJ
протеолиз	NOUN
протеолитический	ADJ
протестировать	VERB
протестный	ADJ
протестный	ADJ
протестующе 	ADV
противнейший	ADJ
противность	NOUN
противоборствующий	ADJ
противобуксовочный	ADJ
противоестественно 	ADV
противозаконно 	ADV
противоион	NOUN
противокорабельный	ADJ
противокосмический	ADJ
противоположно 	ADV
противорадиолокационный	ADJ
противоракета	NOUN
противоретровирусный	ADJ
противоречащий	ADJ
противоречивейший	ADJ
противоречиво 	ADV
противоспутниковый	ADJ
противостоящий	ADJ
противоэрозионный	ADJ
противу 	ADP
прототипический	ADJ
прототипный	ADJ
протяжно 	ADV
профанный	ADJ
профессионально 	ADV
профилактически 	ADV
профицит	NOUN
профицитный	ADJ
профобразование	NOUN
профпригодность	NOUN
прохладно 	ADV
прохоровский	ADJ
процветающий	ADJ
процессинг	NOUN
процессный	ADJ
процессорный	ADJ
процессуально 	ADV
прочно 	ADV
прочувствованно 	ADV
прощально 	ADV
прощанье	NOUN
прощенье	NOUN
пружинисто 	ADV
пруха	NOUN
прытко 	ADV
прямехонько 	ADV
прямокишечный	ADJ
прямолинейно 	ADV
прямоходящий	ADJ
прямохождение	NOUN
пряно 	ADV
псевдорелигиозный	ADJ
психбольница	NOUN
психдиспансер	NOUN
психически 	ADV
психоактивный	ADJ
психованный	ADJ
психодиагностический	ADJ
психокоррекционный	ADJ
психокоррекция	NOUN
психологически 	ADV
психосоматический	ADJ
психосоциальный	ADJ
психотравмировать	VERB
психоэмоциональный	ADJ
птицеперерабатывающий	ADJ
пуансеттия	NOUN
публичка	NOUN
публично 	ADV
пугающе 	ADV
пугливо 	ADV
пукалка	NOUN
пулковский	ADJ
пунктуальнейший	ADJ
пунктуально 	ADV
пурана	NOUN
пурим	NOUN
пусик	NOUN
пусконаладочный	ADJ
пусто 	ADV
пустоглазый	ADJ
пустынно 	ADV
пустяшный	ADJ
путана	NOUN
путанка	NOUN
путано 	ADV
путиловский	ADJ
путинский	ADJ
пушкинистика	NOUN
пущай 	PART
пущать	VERB
пылко 	ADV
пыльно 	ADV
пытливейший	ADJ
пытливо 	ADV
пыхтенье	NOUN
пышно 	ADV
пышнотелый	ADJ
пьяно 	ADV
пьяноватый	ADJ
пятигорский	ADJ
пятидверный	ADJ
пятидесятиградусный	ADJ
пятизвездный	ADJ
пятикомнатный	ADJ
пятилистник	NOUN
пятиметровый	ADJ
пятиступенчатый	ADJ
пятнадцатиминутный	ADJ
пятницкий	ADJ
рабица	NOUN
рабический	ADJ
рабсила	NOUN
рабски 	ADV
равиоли	NOUN
равновероятный	ADJ
равнодушно 	ADV
равномерно 	ADV
равносильно 	ADV
равноудаление	NOUN
равноудаленность	NOUN
радикализация	NOUN
радикально 	ADV
радиоголос	NOUN
радиоигра	NOUN
радиоизлучать	VERB
радиоинженер	NOUN
радиоисточник	NOUN
радиоканал	NOUN
радиокомитет	NOUN
радионуклид	NOUN
радиообмен	NOUN
радиопоглощающий	ADJ
радиоприборный	ADJ
радиопрограмма	NOUN
радиореклама	NOUN
радиорынок	NOUN
радиоуглерод	NOUN
радиоуглеродный	ADJ
радиочастотный	ADJ
радиоэфир	NOUN
радонежский	ADJ
радужно 	ADV
радушно 	ADV
разбойничек	NOUN
разборчиво 	ADV
разбрасывание	NOUN
разбуривание	NOUN
разбухший	ADJ
разведпоиск	NOUN
разведрота	NOUN
разведслужба	NOUN
разведуправление	NOUN
развесовка	NOUN
разветвленный	ADJ
развлекаловка	NOUN
разворачивание	NOUN
разворовывание	NOUN
развязно 	ADV
разгадывание	NOUN
разгневанно 	ADV
разгосударствление	NOUN
раздатка	NOUN
раздвоенный	ADJ
разделенность	NOUN
раздельно 	ADV
раздражающе 	ADV
раздраженно 	ADV
раздрай	NOUN
раздумчиво 	ADV
раззявливать	VERB
разительно 	ADV
различно 	ADV
различье	NOUN
разломный	ADJ
размашисто 	ADV
размеренно 	ADV
размораживание	NOUN
размыкание	NOUN
размытость	NOUN
размышленье	NOUN
разнеживаться	VERB
разновеликий	ADJ
разновидовой	ADJ
разное	NOUN
разномасштабный	ADJ
разнонаправленный	ADJ
разнообразно 	ADV
разноплановый	ADJ
разносторонне 	ADV
разнотравный	ADJ
разноуровневый	ADJ
разноцветье	NOUN
разорванность	NOUN
разочарованно 	ADV
разрозненно 	ADV
разруливать	VERB
разрулить	VERB
разрушительно 	ADV
разрядность	NOUN
разулыбаться	VERB
разумно 	ADV
разыгрывание	NOUN
райдер	NOUN
райжилотдел	NOUN
райкомовский	ADJ
райотдел	NOUN
райпищеторг	NOUN
райпо	NOUN
райпотребсоюз	NOUN
райсуд	NOUN
ракетно-космический	ADJ
раковский	ADJ
раменский	ADJ
ранжирование	NOUN
ранневесенний	ADJ
раскадровка	NOUN
раскатисто 	ADV
раскаянье	NOUN
раскованно 	ADV
раскомандоваться	VERB
раскрепощенность	NOUN
раскручивание	NOUN
раскурочивать	VERB
распараллеливание	NOUN
распахнутость	NOUN
распевка	NOUN
расплывчато 	ADV
расползание	NOUN
расположенность	NOUN
распоследний	ADJ
распределенный	ADJ
распыливание	NOUN
рассекречивание	NOUN
рассерженно 	ADV
рассеянно 	ADV
рассказывание	NOUN
расслабленно 	ADV
расставанье	NOUN
расстрельный	ADJ
расстроенно 	ADV
расстроенный	ADJ
рассудительно 	ADV
растаман	NOUN
растаскивание	NOUN
растерянно 	ADV
расточительно 	ADV
растрескивание	NOUN
растроганно 	ADV
расхристанный	ADJ
расхристанный	ADJ
расчесывание	NOUN
расчетливо 	ADV
расчетно 	ADV
расшатывание	NOUN
рахманиновский	ADJ
рацио	NOUN
рационально 	ADV
рачительно 	ADV
реактогенность	NOUN
реакционнейший	ADJ
реализатор	NOUN
реализуемость	NOUN
реалистически 	ADV
реалистично 	ADV
реальнейший	ADJ
реально 	ADV
реассортант	NOUN
реассортантный	ADJ
реассортация	NOUN
ребрендинг	NOUN
ревертаза	NOUN
ревертант	NOUN
ревниво 	ADV
ревностнейший	ADJ
ревностно 	ADV
революционно 	ADV
регионал	NOUN
регионализация	NOUN
регрессионный	ADJ
регулярнейший	ADJ
регулярно 	ADV
регуляторный	ADJ
редкостно 	ADV
редукционизм	NOUN
режимник	NOUN
резво 	ADV
резервирование	NOUN
резервуарный	ADJ
резидентура	NOUN
резинометаллический	ADJ
резинотехнический	ADJ
резинотканевый	ADJ
резинотросовый	ADJ
резиночка	NOUN
резистентный	ADJ
резко 	ADV
резковато 	ADV
резоннейший	ADJ
резонно 	ADV
результативно 	ADV
резчайший	ADJ
реинжиниринг	NOUN
реинтеграция	NOUN
рейнджер	NOUN
рейсинг	NOUN
рейхсканцелярия	NOUN
рейхсмаршал	NOUN
рейхсминистр	NOUN
рейхсфюрер	NOUN
рекламоноситель	NOUN
рекламщик	NOUN
рекомбинант	NOUN
рекомбинантный	ADJ
рекомендатель	NOUN
реконвалесцент	NOUN
рекордно 	ADV
рекруитмент	NOUN
рекрутинговый	ADJ
ректальный	ADJ
релаксировать	VERB
релевантность	NOUN
религиозно 	ADV
релиз	NOUN
рельефно 	ADV
рельсобалочный	ADJ
ремизовский	ADJ
рентгеноструктурный	ADJ
репликативный	ADJ
респектабельнейший	ADJ
респектабельно 	ADV
рестайлинг	NOUN
рестарт	NOUN
рестлер	NOUN
рестрикционный	ADJ
реструктуризация	NOUN
реструктурировать	VERB
ресурсный	ADJ
ресурсосберегающий	ADJ
ресурсосбережение	NOUN
ресуспендировать	VERB
ретиво 	ADV
ретинол	NOUN
ретривер	NOUN
ретровирус	NOUN
ретроспективно 	ADV
референтура	NOUN
рефлексировать	VERB
рефлекторно 	ADV
реформаторство	NOUN
рецепторный	ADJ
рецепторсвязывающий	ADJ
рецидивировать	VERB
речевка	NOUN
решено 	PRED
решенье	NOUN
решеточка	NOUN
ржаво 	ADV
ржанье	NOUN
рибавирин	NOUN
ридостин	NOUN
римейк	NOUN
рискованнейший	ADJ
рискованно 	ADV
ритейлер	NOUN
ритмически 	ADV
ритмично 	ADV
риторически 	ADV
ритуально 	ADV
риэлтерский	ADJ
риэлторский	ADJ
робко 	ADV
ровенский	ADJ
ровер	NOUN
рогожский	ADJ
род-айланд	NOUN
родный	ADJ
родовитейший	ADJ
родственно 	ADV
родстер	NOUN
рожденье	NOUN
розановский	ADJ
розовенький	ADJ
розыскник	NOUN
рок-н-ролльный	ADJ
рокарий	NOUN
роллерный	ADJ
роллинги	NOUN
романтически 	ADV
романтичнейший	ADJ
романтично 	ADV
роскошно 	ADV
росточек	NOUN
ротавирус	NOUN
роттердамский	ADJ
роуминг	NOUN
рубенсовский	ADJ
рублевский	ADJ
рубоповец	NOUN
рудерал	NOUN
рудеральный	ADJ
рузский	ADJ
рукопашник	NOUN
румянейший	ADJ
румянцевский	ADJ
рунет	NOUN
русскость	NOUN
рутиннейший	ADJ
рыбачок	NOUN
рыбинский	ADJ
рыбодобывающий	ADJ
рыбоперерабатывающий	ADJ
рыбопродукция	NOUN
рыбохозяйственный	ADJ
рыданье	NOUN
рьяно 	ADV
рэпер	NOUN
рюшечка	NOUN
рязановский	ADJ
ряха	NOUN
сабвей	NOUN
сабвуфер	NOUN
савеловский	ADJ
садистски 	ADV
садомазохистский	ADJ
сакральность	NOUN
салабон	NOUN
салатовый	ADJ
салфеточка	NOUN
самарянин	NOUN
самарянка	NOUN
самиздатский	ADJ
самоактуализация	NOUN
самобытнейший	ADJ
самовзвод	NOUN
самовластно 	ADV
самовластье	NOUN
самовольно 	ADV
самовоспроизводиться	VERB
самовыражение	NOUN
самодисциплина	NOUN
самодовольно 	ADV
самодостаточность	NOUN
самодостаточный	ADJ
самозабвенно 	ADV
самоидентификация	NOUN
самойловский	ADJ
самоклеящийся	ADJ
самокопание	NOUN
самокритично 	ADV
самолично 	ADV
самомассаж	NOUN
самонадеянно 	ADV
самообнаружение	NOUN
самоорганизующийся	ADJ
самоотверженно 	ADV
самопровозглашенный	ADJ
самопроизвольно 	ADV
саморазвиваться	VERB
саморегулируемый	ADJ
саморегулирующийся	ADJ
саморез	NOUN
саморефлексия	NOUN
самостоятельно 	ADV
самостраховка	NOUN
самосуществование	NOUN
самоуверенно 	ADV
самоуничтожаться	VERB
самоуничтожиться	VERB
самоуправляемый	ADJ
самоутвердиться	VERB
самоутверждаться	VERB
самохват	NOUN
самоцельный	ADJ
самоцензура	NOUN
самоценность	NOUN
самоценный	ADJ
сандуновский	ADJ
санкт-петербургский	ADJ
санотдел	NOUN
санрота	NOUN
санэпиднадзор	NOUN
сапожниковский	ADJ
саранский	ADJ
саркастически 	ADV
саспенс	NOUN
саудовец	NOUN
саудовский	ADJ
саундтрек	NOUN
сафоновский	ADJ
сахаровский	ADJ
саянский	ADJ
сбалансированность	NOUN
сбеситься	VERB
сбивчиво 	ADV
сбытовый	ADJ
сварливо 	ADV
свежевыжатый	ADJ
свежевырытый	ADJ
свербить	VERB
сверхбогатый	ADJ
сверхдоход	NOUN
сверхкрупный	ADJ
сверхмалый	ADJ
сверхмассивный	ADJ
сверхрешетка	NOUN
сверхсложный	ADJ
сверхсовременный	ADJ
сверхспособность	NOUN
сверхурочно 	ADV
сверхусилие	NOUN
сверхцивилизация	NOUN
светодиод	NOUN
светодиодный	ADJ
светоизлучать	VERB
светоотражающий	ADJ
свиданка	NOUN
свиданье	NOUN
свидетельствование	NOUN
свингер	NOUN
свинокомплекс	NOUN
свинцово 	ADV
свирепо 	ADV
свиридовский	ADJ
свирский	ADJ
свободно 	ADV
своевольно 	ADV
своевременно 	ADV
своеобразнейший	ADJ
своеобразно 	ADV
свойственно 	PRED
сволочанский	ADJ
сворачивание	NOUN
связно 	ADV
святоотеческий	ADJ
священнейший	ADJ
священномученик	NOUN
священноначалие	NOUN
сгенерировать	VERB
сгруппировываться	VERB
сдавленно 	ADV
сдавливание	NOUN
сдвиговый	ADJ
сдержаннейший	ADJ
сдержанно 	ADV
сдерживание	NOUN
сдуваться	VERB
сдуться	VERB
северодвинский	ADJ
северокореец	NOUN
сегментарный	ADJ
сегментировать	VERB
сегнетоэлектрический	ADJ
сегун	NOUN
седиментационный	ADJ
седловой	ADJ
сейсморазведка	NOUN
сейфертовский	ADJ
сейфовый	ADJ
сейшен	NOUN
секвенирование	NOUN
секвенировать	VERB
секвентальный	ADJ
секонд-хенд	NOUN
секретировать	VERB
секретнейший	ADJ
секретно 	ADV
сексуальнейший	ADJ
сексуально 	ADV
секулярный	ADJ
секьюрити	NOUN
секьюритизация	NOUN
селезневский	ADJ
селенье	NOUN
сельповский	ADJ
сельхозземля	NOUN
сельхозинститут	NOUN
сельхозназначение	NOUN
сельхозпредприятие	NOUN
сельхозпродукты	NOUN
сельхозпродукция	NOUN
сельхозпроизводитель	NOUN
сельхозпроизводство	NOUN
сельхозработа	NOUN
сельхозтоваропроизводитель	NOUN
сельхозугодье	NOUN
семантически 	ADV
семейно 	ADV
семеновский	ADJ
семиметровый	ADJ
семипалатинский	ADJ
семиреченский	ADJ
семицветик	NOUN
семязачаток	NOUN
сеноманский	ADJ
сенсационно 	ADV
сенсомоторный	ADJ
сенсор	NOUN
сентиментальнейший	ADJ
сентиментально 	ADV
сенявинский	ADJ
серафимовский	ADJ
сергиевопосадский	ADJ
сердечнейший	ADJ
сердечно 	ADV
сердешный	ADJ
сердито 	ADV
сержантик	NOUN
сериальный	ADJ
серийно 	ADV
серо 	ADV
серовариант	NOUN
серовский	ADJ
сероконверсия	NOUN
серонегативный	ADJ
серопозитивный	ADJ
серотип	NOUN
серотипирование	NOUN
серотонин	NOUN
сертификационный	ADJ
сертифицировать	VERB
серфер	NOUN
серьезно 	ADV
сестричество	NOUN
сжато 	ADV
сиаловый	ADJ
сибириада	NOUN
сиверсия	NOUN
сигмовидный	ADJ
сика	NOUN
сиквел	NOUN
сикль	NOUN
сикстинский	ADJ
силан	NOUN
силикагель	NOUN
силоксановый	ADJ
симбиотический	ADJ
симбирский	ADJ
символически 	ADV
символично 	ADV
символьный	ADJ
симка	NOUN
симметрично 	ADV
симоновский	ADJ
симпатичнейший	ADJ
симпатично 	ADV
симпласт	NOUN
симулякр	NOUN
симулятор	NOUN
синантропный	ADJ
сингл	NOUN
синглетный	ADJ
сингулярность	NOUN
синейший	ADJ
синеклиза	NOUN
синематограф	NOUN
синергетический	ADJ
синтаксически 	ADV
синтезирование	NOUN
синтип	NOUN
синтип	NOUN
синхронно 	ADV
синхротронный	ADJ
синцитиальный	ADJ
синьорита	NOUN
сипло 	ADV
сирконстант	NOUN
сирконстантный	ADJ
сиропчик	NOUN
сиротливо 	ADV
систематически 	ADV
системно 	ADV
системообразующий	ADJ
ситуативно 	ADV
сицилианский	ADJ
сиянье	NOUN
сиятельнейший	ADJ
сказочно 	ADV
скандально 	ADV
скважинный	ADJ
скво	NOUN
сквош	NOUN
скептически 	ADV
скин	NOUN
скинхед	NOUN
складно 	ADV
склеротизовать	VERB
скобелевский	ADJ
скованно 	ADV
сконфуженно 	ADV
скорбно 	ADV
скоропалительно 	ADV
скоропостижно 	ADV
скошенный	ADJ
скраб	NOUN
скрежетнуть	VERB
скремблирование	NOUN
скрининг	NOUN
скрининговый	ADJ
скрипт	NOUN
скрипуче 	ADV
скромно 	ADV
скрупулезнейший	ADJ
скрупулезно 	ADV
скрытно 	ADV
скрыто 	ADV
скудельник	NOUN
скудно 	ADV
скуластенький	ADJ
скупо 	ADV
скучновато 	ADV
скучновато 	PRED
скушный	ADJ
слабослышащий	ADJ
слабослышащий	NOUN
сладко 	ADV
сладостнейший	ADJ
сладостно 	ADV
сладострастнейший	ADJ
сладострастно 	ADV
слаженно 	ADV
слаживание	NOUN
слащаво 	ADV
следак	NOUN
слезно 	ADV
слепо 	ADV
сливовидный	ADJ
слитно 	ADV
словесно 	ADV
словоохотливейший	ADJ
слоган	NOUN
сложновато 	ADV
слот	NOUN
служебно 	ADV
слышание	NOUN
смаргивать	VERB
смарт	NOUN
смачно 	ADV
смектический	ADJ
смело 	ADV
смертельно 	ADV
смертница	NOUN
смершевец	NOUN
смехотворнейший	ADJ
смехотворно 	ADV
смешливо 	ADV
смешнейший	ADJ
смиренно 	ADV
смирно 	ADV
смирновка	NOUN
смирновский	ADJ
смольнинский	ADJ
смраднейший	ADJ
смугло 	ADV
смутнейший	ADJ
смутно 	ADV
смущенно 	ADV
смыкание	NOUN
смыслообразование	NOUN
смыслообразующий	ADJ
смышленнейший	ADJ
смятенно 	ADV
снабсбыт	NOUN
снегокат	NOUN
сникерс	NOUN
снип	NOUN
снисходительно 	ADV
сноровисто 	ADV
сносно 	ADV
сноуборд	NOUN
собираемость	NOUN
соблазнение	NOUN
соблазнительнейший	ADJ
соблазнительно 	ADV
собранье	NOUN
собровец	NOUN
совбез	NOUN
соввласть	NOUN
совершеннейший	ADJ
совершенно 	ADV
совершенномудрый	ADJ
совзнак	NOUN
современнейший	ADJ
современниковский	ADJ
современно 	ADV
согласнейший	ADJ
согласованно 	ADV
содержательнейший	ADJ
содержательно 	ADV
соединительнотканный	ADJ
созданье	NOUN
сознательно 	ADV
соизмерение	NOUN
сокольнический	ADJ
сократический	ADJ
сократовский	ADJ
сокращенно 	ADV
сокровеннейший	ADJ
сокрушенно 	ADV
сокрушительнейший	ADJ
соленосный	ADJ
солженицынский	ADJ
солидарно 	ADV
солидно 	ADV
соликамский	ADJ
солнечногорский	ADJ
солнцевский	ADJ
солнцедар	NOUN
соловьевский	ADJ
солоненковец	NOUN
солунский	ADJ
сольвентный	ADJ
солянум	NOUN
сомелье	NOUN
сомнамбулически 	ADV
сомненье	NOUN
сомнительно 	ADV
сонно 	ADV
соопределение	NOUN
соосный	ADJ
сопенье	NOUN
соподчиненность	NOUN
сопряженность	NOUN
соработничество	NOUN
сорбировать	VERB
сорбционный	ADJ
сорокапятилетний	ADJ
сорокинский	ADJ
соросовский	ADJ
сортиментный	ADJ
соседкин	ADJ
соскальзывание	NOUN
сослужение	NOUN
сосновский	ADJ
сособственник	NOUN
сосредоточенно 	ADV
составляющая	NOUN
соул	NOUN
соучредитель	NOUN
софинансирование	NOUN
софт	NOUN
соцгород	NOUN
соцзащита	NOUN
социалка	NOUN
социальность	NOUN
социум	NOUN
соцкультбыт	NOUN
соцобеспечение	NOUN
соцопрос	NOUN
соцреалистический	ADJ
сочетанье	NOUN
сочно 	ADV
сочувственно 	ADV
спа	NOUN
спаивание	NOUN
спам	NOUN
спародировать	VERB
спасенье	NOUN
спасибочки 	PART
спасительно 	ADV
спассеровать	VERB
спелеосекция	NOUN
спелеотуризм	NOUN
спелеотурист	NOUN
сперматека	NOUN
спермий	NOUN
спецвыпуск	NOUN
спецгруппа	NOUN
спецдепозитарий	NOUN
спецзадание	NOUN
спецзаказ	NOUN
специально 	ADV
специфически 	ADV
спецконтингент	NOUN
спецмашина	NOUN
спецназначение	NOUN
спецналог	NOUN
спецоборудование	NOUN
спецоперация	NOUN
спецпереселенец	NOUN
спецпредложение	NOUN
спецпредставитель	NOUN
спецпроект	NOUN
спецсвязь	NOUN
спецсигнал	NOUN
спецсредства	NOUN
спецсчет	NOUN
спецтема	NOUN
спецтехника	NOUN
спецтранспорт	NOUN
спецучасток	NOUN
спецчасть	NOUN
спецэкспортер	NOUN
спецэффект	NOUN
спешно 	ADV
спикерский	ADJ
спинастернум	NOUN
спирально 	ADV
спиртзавод	NOUN
спиртик	NOUN
спиртосодержащий	ADJ
списочный	ADJ
спичрайтер	NOUN
сплайн	NOUN
спленоцит	NOUN
спойлер	NOUN
спокойнейший	ADJ
спокойненький	ADJ
спокойненько 	ADV
спонсорство	NOUN
спонтанно 	ADV
споро 	ADV
спортивно 	ADV
спортивность	NOUN
спорткар	NOUN
спортпрототип	NOUN
спортшкола	NOUN
способнейший	ADJ
спрайт	NOUN
спрей	NOUN
спрогнозировать	VERB
спружинить	VERB
срабатывание	NOUN
сраженье	NOUN
средневзвешенный	ADJ
средневолжский	ADJ
среднегорный	ADJ
среднегрудь	NOUN
среднедушевой	ADJ
среднемировой	ADJ
среднероссийский	ADJ
среднерыночный	ADJ
среднесписочный	ADJ
среднетяжелый	ADJ
средовый	ADJ
средообразующий	ADJ
срочнейший	ADJ
срочник	NOUN
срочно 	ADV
ссылочка	NOUN
стабильнейший	ADJ
стабильно 	ADV
стабфонд	NOUN
стаканчик	NOUN
сталинец	NOUN
сталинизм	NOUN
сталинистский	ADJ
сталинщина	NOUN
сталкер	NOUN
стандартно 	ADV
старательно 	ADV
стариннейший	ADJ
старицкий	ADJ
старлей	NOUN
стармех	NOUN
старо 	ADV
старомодно 	ADV
старомосковский	ADJ
старпер	NOUN
старчески 	ADV
статистически 	ADV
статкомитет	NOUN
статотчетность	NOUN
статусный	ADJ
стаффорд	NOUN
стейк	NOUN
стеклопакет	NOUN
стеклопластиковый	ADJ
стеклоподъемник	NOUN
стеклотара	NOUN
стеклянно 	ADV
степ	NOUN
степенно 	ADV
стервознейший	ADJ
стервозность	NOUN
стереопара	NOUN
стереосистема	NOUN
стерильно 	ADV
стернит	NOUN
стесненно 	ADV
стеснительно 	ADV
стехиометрический	ADJ
стечкин	NOUN
стик	NOUN
стикер	NOUN
стилистически 	ADV
стильно 	ADV
стимульный	ADJ
стингер	NOUN
стихийно 	ADV
стихотворенье	NOUN
стодолларовый	ADJ
стоически 	ADV
столетье	NOUN
столичность	NOUN
стопроцентно 	ADV
сторожевский	ADJ
сторожко 	ADV
стороной 	ADV
стохастический	ADJ
страдальчески 	ADV
страданье	NOUN
страннейший	ADJ
странновато 	ADV
страновой	ADJ
страновый	ADJ
страстно 	ADV
страта	NOUN
стратегически 	ADV
страусиный	ADJ
страшненький	ADJ
страшно 	ADV
страшно 	PRED
страшное	NOUN
стремительно 	ADV
стремленье	NOUN
стремный	ADJ
стремный	ADJ
стриптизер	NOUN
строгановский	ADJ
строжайше 	ADV
стройиндустрия	NOUN
стройкомплекс	NOUN
стройнейший	ADJ
стройненький	ADJ
стройно 	ADV
стройфак	NOUN
структуризация	NOUN
структурирование	NOUN
структурированность	NOUN
структурировать	VERB
структурно 	ADV
структурообразующий	ADJ
струминский	ADJ
студебеккер	NOUN
студентик	NOUN
студенточка	NOUN
стукачество	NOUN
стукачка	NOUN
стыдливо 	ADV
стэнфордский	ADJ
субабонент	NOUN
субанальный	ADJ
субапикальный	ADJ
субару	NOUN
субвертикальный	ADJ
субвирусный	ADJ
субгенитальный	ADJ
субконтрактация	NOUN
субнациональный	ADJ
субпопуляция	NOUN
субрегиональный	ADJ
субсидиарный	ADJ
субсидирование	NOUN
субсчет	NOUN
субтильнейший	ADJ
субтип	NOUN
субшкала	NOUN
субъединица	NOUN
субъединичный	ADJ
субъективно 	ADV
субъектность	NOUN
суворинский	ADJ
судакский	ADJ
судзуки	NOUN
судзуки	NOUN
судорожно 	ADV
суеверно 	ADV
суетливо 	ADV
сузуки	NOUN
суицид	NOUN
суксунский	ADJ
сумароковский	ADJ
сумасброднейший	ADJ
сумасшедше 	ADV
суматошно 	ADV
сумбурно 	ADV
сумеречно 	ADV
суммарно 	ADV
сумо	NOUN
супер	NOUN
супер 	ADJ
супер 	PRED
супергерой	NOUN
супергигант	NOUN
супердержава	NOUN
супердорогой	ADJ
суперкомпьютер	NOUN
суперкомпьютерный	ADJ
суперлига	NOUN
супермодный	ADJ
супернатант	NOUN
супероксид	NOUN
суперподделка	NOUN
суперпозиция	NOUN
суперпопулярный	ADJ
суперсерия	NOUN
суперский	ADJ
суперсовременный	ADJ
суперстар	NOUN
супертанкер	NOUN
супертурнир	NOUN
суперфинал	NOUN
суперхит	NOUN
супрематический	ADJ
сургутский	ADJ
сурдоперевод	NOUN
суриковский	ADJ
суровейший	ADJ
сурово 	ADV
сурожский	ADJ
сурфактант	NOUN
суфий	NOUN
сухаревский	ADJ
суховато 	ADV
сучонок	NOUN
существующий	ADJ
сущностно 	ADV
сущностный	ADJ
сфальсифицировать	VERB
сформированность	NOUN
схавать	VERB
схватывание	NOUN
схематически 	ADV
схематично 	ADV
схиархимандрит	NOUN
сходненский	ADJ
сходняк	NOUN
схрон	NOUN
сцеживание	NOUN
сценографический	ADJ
сцинтилляционный	ADJ
счастие	NOUN
сшивание	NOUN
сызранский	ADJ
сыктывкарский	ADJ
сыновий	ADJ
сыновство	NOUN
сыровяленый	ADJ
сырьевик	NOUN
сыскарь	NOUN
сытно 	ADV
сыто 	ADV
сюжетно 	ADV
сюр	NOUN
сявка	NOUN
таблетировать	VERB
таблеточка	NOUN
таблоид	NOUN
табуреточка	NOUN
таганковский	ADJ
таганский	ADJ
таец	NOUN
таинственнейший	ADJ
таинственно 	ADV
тайванец	NOUN
тайваньский	ADJ
тайка	NOUN
таймшер	NOUN
тайнейший	ADJ
тайшетский	ADJ
такка	NOUN
тактически 	ADV
тактичнейший	ADJ
тактично 	ADV
таламус	NOUN
талантливо 	ADV
талдомский	ADJ
талибан	NOUN
талибский	ADJ
таманец	NOUN
тамиздат	NOUN
тампакс	NOUN
тампонажный	ADJ
тан	NOUN
тантрийский	ADJ
тантрический	ADJ
танцпол	NOUN
тарак	NOUN
тарасовский	ADJ
тарахтенье	NOUN
таргетирование	NOUN
тарзанка	NOUN
таро	ADJ
тарский	ADJ
тарусский	ADJ
таскание	NOUN
татарстанский	ADJ
тату	NOUN
таунхаус	NOUN
тварность	NOUN
тварный	ADJ
твердотельный	ADJ
твердотопливный	ADJ
твердофазный	ADJ
творенье	NOUN
творчески 	ADV
твэл	NOUN
театрально 	ADV
театрик	NOUN
тейп	NOUN
тейповый	ADJ
текила	NOUN
текстовый	ADJ
текстуально 	ADV
текстурный	ADJ
телеведущая	NOUN
телеведущий	NOUN
телегид	NOUN
тележурналист	NOUN
телеигра	NOUN
телек	NOUN
телеканал	NOUN
теленовость	NOUN
телепузик	NOUN
телеработа	NOUN
телерадиовещание	NOUN
телерадиовещатель	NOUN
телерадиовещательный	ADJ
телерадиокомпания	NOUN
телесистема	NOUN
телесно 	ADV
телефончик	NOUN
телеящик	NOUN
тематически 	ADV
темнохвойный	ADJ
темпераментно 	ADV
темпоральный	ADJ
тенге	NOUN
тензодатчик	NOUN
тенишевский	ADJ
теоретически 	ADV
тепловизионный	ADJ
теплоизолированный	ADJ
теплоизолировать	VERB
теплообменный	ADJ
теплофизика	NOUN
теплофизический	ADJ
теплоэнергия	NOUN
теплынец	NOUN
теплынский	ADJ
тергит	NOUN
тереховский	ADJ
терм	NOUN
терменвокс	NOUN
терминологика	NOUN
терминосистема	NOUN
термокамера	NOUN
термоусадочный	ADJ
терновский	ADJ
терпеливейший	ADJ
терпеливо 	ADV
терпенье	NOUN
терракт	NOUN
терригенный	ADJ
территориально 	ADV
тесла	NOUN
тесновато 	ADV
тест-драйв	NOUN
тестер	NOUN
тетраметилбензидин	NOUN
тетрафторэтилен	NOUN
тетрис	NOUN
технически 	ADV
техно	ADJ
техно	NOUN
технокомплекс	NOUN
технокомплект	NOUN
технологически 	ADV
технологичность	NOUN
технопарк	NOUN
технополис	NOUN
техноэласт	NOUN
техпаспорт	NOUN
техсовет	NOUN
техцентр	NOUN
теченье	NOUN
тивериадский	ADJ
тильзитский	ADJ
тиманский	ADJ
тимирязевский	ADJ
тимус	NOUN
типирование	NOUN
типичнейший	ADJ
типологизация	NOUN
типологически 	ADV
типоспецифический	ADJ
тиражирование	NOUN
тиристорный	ADJ
титулованнейший	ADJ
тихарь	NOUN
тихо 	ADV
тихоновский	ADJ
тихохонько 	ADV
тишинский	ADJ
товародвижение	NOUN
товаропроводящий	ADJ
товаросопроводительный	ADJ
токсоплазмоз	NOUN
толедский	ADJ
толковище	NOUN
толково 	ADV
толлинг	NOUN
толос	NOUN
толстейший	ADJ
толстеннейший	ADJ
тольяттинский	ADJ
томительно 	ADV
томнейший	ADJ
томно 	ADV
тональник	NOUN
тоненько 	ADV
тонко 	ADV
тонкопленочный	ADJ
топ-менеджер	NOUN
топик	NOUN
топорно 	ADV
топорок	NOUN
топос	NOUN
торжественнейший	ADJ
торжественно 	ADV
торжествующе 	ADV
торопливо 	ADV
торопыжка	NOUN
торсионный	ADJ
тоскливейший	ADJ
тосол	NOUN
тотально 	ADV
тотальность	NOUN
тотошник	NOUN
точняк 	ADV
точняк 	PART
травмирование	NOUN
травмоопасный	ADJ
травмпункт	NOUN
трагически 	ADV
трагичнейший	ADJ
трагично 	ADV
традиционалистский	ADJ
традиционнейший	ADJ
традиционно 	ADV
трайбалистский	ADJ
транзакция	NOUN
транзитка	NOUN
транкинговый	ADJ
трансакционный	ADJ
трансгенный	ADJ
трансграничный	ADJ
трансивер	NOUN
транскриптаза	NOUN
транслит	NOUN
трансмиссивный	ADJ
трансмутация	NOUN
транснационализация	NOUN
транспарентность	NOUN
транспарентный	ADJ
трансплантология	NOUN
транспортабельность	NOUN
трансрегиональный	ADJ
трансфекция	NOUN
трансфер	NOUN
трансферный	ADJ
трансфертный	ADJ
трансформер	NOUN
трансценденция	NOUN
трансцендирование	NOUN
транш	NOUN
трассовый	ADJ
траурно 	ADV
трафик	NOUN
требовательно 	ADV
треволненье	NOUN
трезво 	ADV
трезвомыслящий	ADJ
трейдер	NOUN
трейдинг	NOUN
тремор	NOUN
тренд	NOUN
треники	NOUN
тренированнейший	ADJ
трепетно 	ADV
тресветлый	ADJ
третьяковский	ADJ
треугольничек	NOUN
трехгрошовый	ADJ
трехкомпонентный	ADJ
трехочковый	ADJ
трехсотка	NOUN
трехуровневый	ADJ
трещиноватость	NOUN
тривакцина	NOUN
тривиальнейший	ADJ
тривиально 	ADV
триггер	NOUN
тридцатипятилетний	ADJ
тридцатитрехлетний	ADJ
тридцатник	NOUN
триколор	NOUN
триммер	NOUN
тринадцатилетний	ADJ
триумфально 	ADV
трифоновский	ADJ
трогание	NOUN
трогательнейший	ADJ
трогательно 	ADV
троекратно 	ADV
троекуровский	ADJ
тройский	ADJ
тропный	ADJ
тротиловый	ADJ
троян	NOUN
трудник	NOUN
трудновыполнимый	ADJ
трудноизвлекаемый	ADJ
трудноразрешимый	ADJ
трудносгораемый	ADJ
трудоголик	NOUN
трудозатрата	NOUN
трудозатраты	NOUN
трудолюбиво 	ADV
труповозка	NOUN
трусливо 	ADV
трусцой 	ADV
туговато 	ADV
тулка	NOUN
туманец	NOUN
туманнейший	ADJ
туманно 	ADV
туннельный	ADJ
тупо 	ADV
турбировать	VERB
турбодетандер	NOUN
турбодизель	NOUN
турбонаддув	NOUN
турбюро	NOUN
турка	NOUN
туркменбаши	NOUN
туркменбаши	NOUN
туроператор	NOUN
туроператорский	ADJ
турпоездка	NOUN
турпродукт	NOUN
турпутевка	NOUN
турфирма	NOUN
тускло 	ADV
тусовочный	ADJ
тусовщик	NOUN
тутси	NOUN
тушинец	NOUN
тхэквондо	NOUN
тщательнейший	ADJ
тщательно 	ADV
тыняновский	ADJ
тысячекратно 	ADV
тысячелетье	NOUN
тюнер	NOUN
тюнинг	NOUN
тюнинговый	ADJ
тюренский	ADJ
тюряга	NOUN
тютчевский	ADJ
тяговооруженность	NOUN
тягуче 	ADV
тяжеловесно 	ADV
тяжчайший	ADJ
уазик	NOUN
убалтывать	VERB
убедительно 	ADV
убежденно 	ADV
убийственно 	ADV
убито 	ADV
убого 	ADV
убытие	NOUN
уважительно 	ADV
увековечивание	NOUN
уверенно 	ADV
увеселенье	NOUN
увесисто 	ADV
увиденное	NOUN
увлажняющий	ADJ
увлекательно 	ADV
увлеченно 	ADV
увядающий	ADJ
углепластик	NOUN
углепластиковый	ADJ
угловато 	ADV
углубленно 	ADV
угнетающе 	ADV
угодливо 	ADV
уголовка	NOUN
уголовно 	ADV
угощенье	NOUN
угрешский	ADJ
угрожающе 	ADV
угрюмо 	ADV
ударно 	ADV
ударопрочный	ADJ
удачно 	ADV
удерживание	NOUN
удивленно 	ADV
удивленье	NOUN
удовлетворенно 	ADV
удостоверительный	ADJ
удручающе 	ADV
удрученно 	ADV
уединенно 	ADV
ужасающе 	ADV
ужастик	NOUN
узко 	ADV
узконаправленный	ADJ
узкоспециализированный	ADJ
узнаваемо 	ADV
узнаваемость	NOUN
уимблдонский	ADJ
уклончиво 	ADV
укольчик	NOUN
укорененность	NOUN
укоризненно 	ADV
укоряющий	ADJ
укрепрайон	NOUN
улаживание	NOUN
уловимо 	ADV
улыбчиво 	ADV
ультрадисперсный	ADJ
ультрафиолет	NOUN
ультрацентрифугирование	NOUN
уманский	ADJ
умело 	ADV
уменье	NOUN
умеренно 	ADV
уместно 	ADV
умиленно 	ADV
умильно 	ADV
умиротворенно 	ADV
умиротворяющий	ADJ
умма	NOUN
умничка	NOUN
умозрительно 	ADV
умоляюще 	ADV
умопостигаемый	ADJ
уморительно 	ADV
умственно 	ADV
умышленно 	ADV
универ	NOUN
универсалистский	ADJ
универсально 	ADV
униженно 	ADV
унизительно 	ADV
уникально 	ADV
унисекс	NOUN
унитовец	NOUN
уничижительно 	ADV
уныло 	ADV
уплотнительный	ADJ
уплощенный	ADJ
упоенно 	ADV
упоительно 	ADV
упорно 	ADV
упорядочивание	NOUN
управомоченный	ADJ
упреждающий	ADJ
упрощенно 	ADV
упруго 	ADV
упрямо 	ADV
упс 	INTJ
урезание	NOUN
урка	NOUN
уровневый	ADJ
урогенитальный	ADJ
уродливо 	ADV
усердно 	ADV
усиленно 	ADV
ускоренно 	ADV
условно 	ADV
услужливо 	ADV
услышанное	NOUN
усмешечка	NOUN
усмешливо 	ADV
успеться	VERB
успешно 	ADV
успокаивающе 	ADV
успокоенно 	ADV
успокоительно 	ADV
успокоительное	NOUN
усреднение	NOUN
устало 	ADV
установленный	ADJ
устно 	ADV
устность	NOUN
устойчиво 	ADV
устрашающе 	ADV
усыхание	NOUN
утвердительно 	ADV
утесовский	ADJ
утилита	NOUN
утилитарно 	ADV
утомительно 	ADV
утонченно 	ADV
утрированно 	ADV
утробно 	ADV
ухмылочка	NOUN
ухоженность	NOUN
участливо 	ADV
учащенно 	ADV
учебка	NOUN
ученье	NOUN
училка	NOUN
учителка	NOUN
учтиво 	ADV
учхоз	NOUN
ушатик	NOUN
уширение	NOUN
фабзавком	NOUN
файловый	ADJ
фактик	NOUN
фактически 	ADV
фактологический	ADJ
факторинг	NOUN
факторный	ADJ
факультативно 	ADV
фаллоимитатор	NOUN
фальшиво 	ADV
фамильярно 	ADV
фан	NOUN
фан-клуб	NOUN
фанатически 	ADV
фанатично 	ADV
фанатский	ADJ
фантазийный	ADJ
фантастически 	ADV
фантастично 	ADV
фатально 	ADV
фаустовский	ADJ
федоровский	ADJ
федоровский	ADJ
феминность	NOUN
феминный	ADJ
фенечка	NOUN
фенилаланин	NOUN
фенилкетонурия	NOUN
фенольный	ADJ
феноменально 	ADV
фенотипический	ADJ
фенька	NOUN
феромон	NOUN
фестивальный	ADJ
фетальный	ADJ
фетовский	ADJ
фиановский	ADJ
фибробласт	NOUN
фиброузный	ADJ
фигушки 	PART
фигушки 	PRED
физиологически 	ADV
физически 	ADV
физподготовка	NOUN
физраствор	NOUN
филевский	ADJ
филигранно 	ADV
филипповский	ADJ
филовирус	NOUN
философски 	ADV
фильма	NOUN
финагент	NOUN
финансово 	ADV
финрезерв	NOUN
фиолетово 	ADV
фирмочка	NOUN
фитбол	NOUN
фитнес	NOUN
фитнес-клуб	NOUN
фитомасса	NOUN
фитонцидный	ADJ
фитотерапия	NOUN
фитоэкдистероид	NOUN
фитоэссенция	NOUN
флавивирус	NOUN
флегматично 	ADV
флоридский	ADJ
флоэма	NOUN
флюидодинамический	ADJ
флюоресцентный	ADJ
фокинский	ADJ
фоккер	NOUN
фокус-группа	NOUN
фондоотдача	NOUN
фонетически 	ADV
форвардный	ADJ
фордовский	ADJ
формально 	ADV
форматирование	NOUN
формационный	ADJ
формообразующий	ADJ
формочка	NOUN
формульный	ADJ
форс-мажор	NOUN
фортепианный	ADJ
форумчанин	NOUN
фосфазид	NOUN
фосфатаза	NOUN
фосфолипид	NOUN
фотка	NOUN
фотобиеннале	NOUN
фотоизображение	NOUN
фотопроба	NOUN
фотопроводимость	NOUN
фоторобот	NOUN
фотосессия	NOUN
фотостудия	NOUN
фотохудожник	NOUN
фрагментарно 	ADV
фразеологически 	ADV
фразочка	NOUN
фрактал	NOUN
фрактальный	ADJ
франчайзинг	NOUN
франшиза	NOUN
фрейм	NOUN
фреймовый	ADJ
френд	NOUN
френсис	NOUN
фрик	NOUN
фрик	NOUN
фрикция	NOUN
фрицевский	ADJ
фройляйн	NOUN
фруктоед	NOUN
фторид	NOUN
фторидный	ADJ
фтормономер	NOUN
фторполимер	NOUN
фуллерен	NOUN
фумарольный	ADJ
фунгицид	NOUN
фундаменталистский	ADJ
фундаментально 	ADV
функционал	NOUN
функционально 	ADV
функциональность	NOUN
фуркастернум	NOUN
фуршетный	ADJ
футеровочный	ADJ
футурум	NOUN
фуфло	NOUN
фэн-шуй	NOUN
фээсбэшник	NOUN
хабаровчанин	NOUN
хавать	VERB
хадис	NOUN
хайль 	INTJ
халабуда	NOUN
халкидонский	ADJ
халтурка	NOUN
халявный	ADJ
халявщик	NOUN
хаммер	NOUN
хамовнический	ADJ
ханец	NOUN
ханка	NOUN
хантавирус	NOUN
хантавирусный	ADJ
ханьский	ADJ
хаотически 	ADV
хаотично 	ADV
характерно 	ADV
харбинский	ADJ
хард	NOUN
хард-рок	NOUN
харизматик	NOUN
хасавюртовский	ADJ
хасанский	ADJ
хаханьки	NOUN
хаханьки	NOUN
хвалынский	ADJ
хвастливо 	ADV
хвостохранилище	NOUN
хедхантер	NOUN
хей 	INTJ
хелатообразующий	ADJ
хелло 	INTJ
хельсинский	ADJ
хемилюминесценция	NOUN
хемокин	NOUN
хемокиновый	ADJ
хеннесси	NOUN
херсонский	ADJ
хехекать	VERB
химерный	ADJ
химзавод	NOUN
химиопрепарат	NOUN
химически 	ADV
химоружие	NOUN
химпром	NOUN
хитромудрый	ADJ
хитроумно 	ADV
хиханьки	NOUN
хиханьки	NOUN
хищно 	ADV
хладнокровно 	ADV
хламидийный	ADJ
хламидия	NOUN
хлебокомбинат	NOUN
хлестко 	ADV
хлеще	ADJ
хлеще	ADV
хлеще	PRED
хлопотливо 	ADV
хлоридный	ADJ
хмуро 	ADV
хоббит	NOUN
ходко 	ADV
ходынский	ADJ
хозблок	NOUN
хоздвор	NOUN
хозяйски 	ADV
хозяйственно 	ADV
холин	NOUN
холловский	ADJ
холодоадаптированный	ADJ
хоперский	ADJ
хорошевский	ADJ
хоспис	NOUN
хостинг	NOUN
хохловский	ADJ
храбро 	ADV
хрень	NOUN
хрипло 	ADV
хрипловато 	ADV
христологический	ADJ
христология	NOUN
хроматографический	ADJ
хроматография	NOUN
хронизация	NOUN
хронически 	ADV
хронологически 	ADV
хронотоп	NOUN
хрупко 	ADV
хрущевка	NOUN
хрущевский	ADJ
хрущевский	ADJ
хрущоба	NOUN
хряпнуть	VERB
художественно 	ADV
хэллоуин	NOUN
хэтчбек	NOUN
царевский	ADJ
царицынский	ADJ
царскосельский	ADJ
царственно 	ADV
цвергшнауцер	NOUN
цветаевский	ADJ
цедент	NOUN
цековский	ADJ
целенаправленно 	ADV
целеобразование	NOUN
целеполагание	NOUN
целесообразно 	ADV
целеуказание	NOUN
целеуказатель	NOUN
целеустремленно 	ADV
целительница	NOUN
целительство	NOUN
целка	NOUN
целлюлит	NOUN
целокупность	NOUN
целомудренно 	ADV
целочисленный	ADJ
централизованно 	ADV
центральноазиатский	ADJ
центризбирком	NOUN
центрифугирование	NOUN
цепко 	ADV
церемонно 	ADV
церка	NOUN
церква	NOUN
цессионарий	NOUN
цессия	NOUN
цивилизационный	ADJ
цивилизованно 	ADV
цивилистический	ADJ
цигун	NOUN
циклически 	ADV
циклоферон	NOUN
цилиндрик	NOUN
цинично 	ADV
цинкование	NOUN
цирконовый	ADJ
цирконоцен	NOUN
цистеин	NOUN
цитатник	NOUN
цитогенетический	ADJ
цитокин	NOUN
цитокин	NOUN
цитокинин	NOUN
цитокиновый	ADJ
цитомегаловирус	NOUN
цитомегаловирусный	ADJ
цитопатический	ADJ
цитопатогенный	ADJ
цитотоксический	ADJ
цитотоксичность	NOUN
цифирка	NOUN
цусимский	ADJ
цыпа	NOUN
чаадаевский	ADJ
чабрец	NOUN
чак-чак	NOUN
чакра	NOUN
чапаевский	ADJ
чапать	VERB
чаплинский	ADJ
чарт	NOUN
частинский	ADJ
частично 	ADV
часто 	ADV
чаянье	NOUN
чейнджер	NOUN
чел	NOUN
человекобог	NOUN
челюскинец	NOUN
ченсфильдский	ADJ
чердынец	NOUN
чердынский	ADJ
черемушкинский	ADJ
черемховский	ADJ
черешчатый	ADJ
черкизовский	ADJ
черно 	ADV
черпаловидный	ADJ
черри	NOUN
чертовый	ADJ
чесменский	ADJ
честно 	ADV
четвертьвековой	ADJ
четко 	ADV
четырехметровый	ADJ
четырехступенчатый	ADJ
четырехцилиндровый	ADJ
чеховский	ADJ
чечен	NOUN
чеченизация	NOUN
чижиха	NOUN
чикаться	VERB
чимкентский	ADJ
чинарь	NOUN
чинно 	ADV
чинопоследование	NOUN
численно 	ADV
чистенько 	ADV
чистопрудный	ADJ
чистосердечно 	ADV
чифир	NOUN
чихание	NOUN
чкаловец	NOUN
чкаловский	ADJ
чкаловский	ADJ
члениковый	ADJ
членовоз	NOUN
членораздельно 	ADV
чмо	NOUN
чопорно 	ADV
чрезвычайка	NOUN
чубайсовский	ADJ
чувак	NOUN
чувиха	NOUN
чувиха	NOUN
чувственно 	ADV
чувствительно 	ADV
чудесно 	ADV
чудесно 	PART
чудесно 	PRED
чудненько 	ADV
чудненько 	PART
чудовищно 	ADV
чудотворение	NOUN
чуждо 	ADV
чужеродность	NOUN
чуйский	ADJ
чумка	NOUN
чупа-чупс	NOUN
чутко 	ADV
чуточка	NOUN
чучхе	NOUN
шабат	NOUN
шагание	NOUN
шаговый	ADJ
шалашовка	NOUN
шаловливо 	ADV
шаляпинский	ADJ
шаманка	NOUN
шандарахнуть	VERB
шансон	NOUN
шапочно 	ADV
шарага	NOUN
шариатский	ADJ
шариться	VERB
шартрский	ADJ
шатко 	ADV
шатойский	ADJ
шаттл	NOUN
шатурский	ADJ
шаурма	NOUN
шахид	NOUN
шахидка	NOUN
шахтинский	ADJ
шашлычник	NOUN
шелкопрядник	NOUN
шелупонь	NOUN
шельфовый	ADJ
шемаханский	ADJ
шереметевский	ADJ
шереметьевский	ADJ
шестилапый	ADJ
шестиместный	ADJ
шестиметровый	ADJ
шестисторонний	ADJ
шестиступенчатый	ADJ
шестицилиндровый	ADJ
шивера	NOUN
шизо	NOUN
шикарно 	ADV
шиловичский	ADJ
шиловский	ADJ
шильдик	NOUN
шипастый	ADJ
шипенье	NOUN
шипик	NOUN
шипкинский	ADJ
шипованный	ADJ
шипр	NOUN
ширяться	VERB
шифрование	NOUN
шифротелеграмма	NOUN
шкапчик	NOUN
шкворчать	VERB
шконка	NOUN
шлюшка	NOUN
шмайссер	NOUN
шмонать	VERB
шмотка	NOUN
шнобель	NOUN
шобла	NOUN
шолоховский	ADJ
шопеновский	ADJ
шорт-трек	NOUN
шортики	NOUN
шоумен	NOUN
шоферюга	NOUN
шпатлевка	NOUN
шпинель	NOUN
шпиономания	NOUN
шпунтик	NOUN
шрамик	NOUN
штабелер	NOUN
штаммовый	ADJ
штампик	NOUN
штандартенфюрер	NOUN
штатник	NOUN
штатно 	ADV
штатовский	ADJ
штурмбанфюрер	NOUN
шукшинский	ADJ
шунтирование	NOUN
шуршанье	NOUN
шустро 	ADV
шутковать	VERB
шутливо 	ADV
шухер	NOUN
щебетанье	NOUN
щегольский	ADJ
щедринский	ADJ
щедро 	ADV
щековый	ADJ
щелковский	ADJ
щемяще 	ADV
щербинский	ADJ
щукинский	ADJ
эволюционно 	ADV
эгейский	ADJ
эго	NOUN
эйдос	NOUN
эйлеров	ADJ
эйнштейновский	ADJ
эйфорический	ADJ
экдизон	NOUN
экдистероид	NOUN
экдистероидсодержащий	ADJ
экзистенция	NOUN
экклезиологический	ADJ
экклезиология	NOUN
экологически 	ADV
экологичность	NOUN
экологичный	ADJ
экономически 	ADV
экономично 	ADV
экономно 	ADV
экорегион	NOUN
экосфера	NOUN
экранирование	NOUN
экранчик	NOUN
экситон	NOUN
эксклюзивность	NOUN
экспедирование	NOUN
экспериментально 	ADV
эксплицитно 	ADV
эксплицитный	ADJ
эксплуатант	NOUN
экспонирование	NOUN
экспортоориентированный	ADJ
экспрессировать	VERB
экстракласс	NOUN
экстраполятор	NOUN
экстремал	NOUN
экстренно 	ADV
экстрим	NOUN
экструдат	NOUN
экструзия	NOUN
элегантно 	ADV
электрика	NOUN
электрически 	ADV
электрогидравлический	ADJ
электроинструмент	NOUN
электронка	NOUN
электронно-вычислительный	ADJ
электроорган	NOUN
электропакет	NOUN
электросвязь	NOUN
электросетевой	ADJ
электросопротивление	NOUN
электросталеплавильный	ADJ
электростеклоподъемник	NOUN
электрофореграмма	NOUN
электрофоретический	ADJ
электрочайник	NOUN
электроэнергетический	ADJ
элементарно 	ADV
элементный	ADJ
элементоорганический	ADJ
элистинский	ADJ
элитарность	NOUN
эльгенский	ADJ
эмо	NOUN
эмотивный	ADJ
эмоционально 	ADV
эмпирически 	ADV
эмульгировать	VERB
эмульситатор	NOUN
энгельсский	ADJ
эндонуклеаза	NOUN
эндорфин	NOUN
эндосперм	NOUN
эндотелиальный	ADJ
эндотелиоцит	NOUN
энергетически 	ADV
энергично 	ADV
энергозатраты	NOUN
энергоисточник	NOUN
энергокомиссия	NOUN
энергокомпания	NOUN
энергонадзор	NOUN
энергообеспечение	NOUN
энергопакет	NOUN
энергопотребление	NOUN
энергоресурсы	NOUN
энергореформа	NOUN
энергосберегающий	ADJ
энергосбережение	NOUN
энергосбыт	NOUN
энергоснабжаемый	ADJ
энерготариф	NOUN
энергохолдинг	NOUN
энергоэффективный	ADJ
энка	NOUN
энтальпия	NOUN
энтеровирус	NOUN
энтеровирусный	ADJ
энтропийный	ADJ
энцефаломиелит	NOUN
энцефалопатия	NOUN
эон	NOUN
эпатажный	ADJ
эпизодически 	ADV
эпикотиль	NOUN
эпилятор	NOUN
эпипрокт	NOUN
эпистемология	NOUN
эпитаксиальный	ADJ
эпитаксия	NOUN
эпитоп	NOUN
эпифитный	ADJ
эпически 	ADV
эпоксидный	ADJ
эргономичный	ADJ
эрдель	NOUN
эрликон	NOUN
эрмитажный	ADJ
эротология	NOUN
эска	NOUN
эспрессо	NOUN
эссеистика	NOUN
эстетизировать	VERB
эстетично 	ADV
эсторский	ADJ
этанол	NOUN
этапность	NOUN
этиотропный	ADJ
этически 	ADV
этнически 	ADV
этничность	NOUN
этнокультурный	ADJ
этнонациональный	ADJ
этнонация	NOUN
этнополитический	ADJ
этнопсихологический	ADJ
этносоциальный	ADJ
этнофункциональный	ADJ
эфериец	NOUN
эфросовский	ADJ
эффективно 	ADV
эффектно 	ADV
эффектор	NOUN
эфэсбэшник	NOUN
эхоподавитель	NOUN
ювелирша	NOUN
ювенильный	ADJ
южак	NOUN
южинский	ADJ
южно-африканский	ADJ
южноафриканец	NOUN
южносибирский	ADJ
юзер	NOUN
юниорский	ADJ
юридически 	ADV
юрисдикционный	ADJ
юрлицо	NOUN
юсуповский	ADJ
яволь 	INTJ
явственно 	ADV
ядовито 	ADV
язвительно 	ADV
языковидный	ADJ
якитория	NOUN
яковлевский	ADJ
якши 	INTJ
якши 	INTJ
ямальский	ADJ
ямбургский	ADJ
яппи	NOUN
ярко 	ADV
яростно 	ADV
яснополянский	ADJ
